##########
#######  #
#   ### .#
#  $#### #
# $   .. #
## #   . #
#   ##@  #
# $  $   #
#    #  ##
##########
