##########
#        #
#  #  #  #
####  ## #
#. ####  #
#$ ##. $ #
#     @$ #
###    $ #
###.  # .#
##########
