##########
###      #
###     .#
### #  # #
#.  ##   #
#   ## $##
## ###@  #
# $*## #*#
#        #
##########
