##########
###   #  #
# $ . $  #
#   . #  #
##$####  #
##    .  #
####  @###
##   # $ #
## .     #
##########
