##########
#     ####
#  #. #  #
# .# ##  #
#  #   # #
# .  #$  #
##    @$$#
### #  $.#
###      #
##########
