##########
####.  $ #
## $. #  #
## ####  #
## ### $##
## ###   #
## ###@$ #
#     #. #
#  #.    #
##########
