##########
####.    #
## $.#.  #
## ####  #
##  ###. #
##  # $  #
#   # @$ #
#     #$ #
#  #     #
##########
