##########
#### $ . #
## $     #
#   #$#$##
#  .# #  #
# #    # #
#     +# #
#   ##   #
#    .   #
##########
