##########
#* ##   ##
#   # $  #
##    $  #
#  #### ##
# .#  #$ #
####  +  #
####   . #
####     #
##########
