##########
# .   ####
#  # $   #
#  ##$# *#
#  ## #  #
#    $  ##
#  ## @  #
#   .   .#
#    #  ##
##########
