##########
#     ####
# . ..   #
#  #  #* #
# ## ### #
#        #
#    $@$ #
# # ##$###
#      ###
##########
