##########
####     #
##    ## #
#   ####.#
# ###* # #
# *##  #.#
#  ###@# #
# # $  $ #
#        #
##########
