##########
##       #
## .   $.#
##  ###  #
## # .#$ #
#     #  #
#     @# #
#### #$$ #
####   . #
##########
