##########
#  #    ##
#.. $  * #
##  ###  #
#######$ #
#    #   #
#     +###
# $  #   #
#        #
##########
