##########
#  ## *###
#   $  ###
#  #  #  #
#$$## #  #
# .     ##
#.  # @  #
#        #
#  #.    #
##########
