##########
#  #  #  #
# $#  $. #
#  #   # #
# $##### #
#  ##  # #
# ..# @# #
#   #  $ #
#.       #
##########
