##########
##########
##  #  ###
#      ###
#  #######
#   .$.$ #
##    @# #
#.  ##$* #
#        #
##########
