##########
####   ###
#* #$ $ ##
#    ##  #
## #  ## #
#     # .#
#  #  @  #
# #   .  #
# $. #   #
##########
