##########
##. ###* #
# $ ###  #
#  #   # #
# ## $ # #
#  # # # #
# .#  @  #
## $ # ###
##.    ###
##########
