##########
####.   ##
####     #
####  # $#
####  #  #
##       #
##$*# @# #
#   ## $ #
#.  ##  .#
##########
