##########
# . ###  #
#   #  $ #
#    $ $ #
##.#  $# #
## ##    #
## ## @  #
##  .    #
###  .  ##
##########
