##########
###   #  #
##.   #$ #
##   ##. #
##  ###  #
##  #### #
#.   $@# #
#   # $  #
##.  $   #
##########
