##########
## .#  ###
##      ##
### #.#$ #
#   #    #
# # #   ##
#   # @  #
##* ##$# #
##  $.   #
##########
