##########
#  .     #
# # #    #
#   #### #
# . ###  #
##$.#  $ #
## .  @$##
###   $  #
###  #   #
##########
