##########
##########
####  #  #
#  ..$   #
#  .  #  #
#### $#  #
####  @###
# $ $  ###
#   .  ###
##########
