##########
##    #  #
##     $ #
####$$$# #
# .    # #
# #  #   #
#.    @. #
# #   #  #
#    ## .#
##########
