##########
#  ##.   #
#.       #
##  #  # #
####  #  #
## $ $ $.#
## ## @#.#
##   #$  #
###     ##
##########
