##########
##  ######
##    #  #
##### #  #
#### .#  #
##   .#$ #
##$   @$ #
#      #*#
#   .#   #
##########
