##########
##  .  $ #
##* #    #
##  #### #
#####    #
##### . ##
##### @  #
#   $    #
#   $.   #
##########
