##########
##  ##  ##
#   ##  ##
#  ###  ##
## *  #$##
# $   #. #
# .#  @  #
#   #  # #
#    *   #
##########
