##########
# .#######
# $ ###  #
##       #
### #### #
##.   #  #
##  . @  #
##    $$ #
## .   $ #
##########
