##########
#  ##  ###
# $ #  ###
# $  $ ###
#..#  # .#
#        #
#  ## @  #
#$ #     #
#      . #
##########
