##########
###   #  #
## $ $# *#
##   .   #
##  ######
###$ #   #
##    @ .#
#        #
#     .  #
##########
