##########
##. ###  #
#   # .$ #
#  ## #  #
#  ##  # #
# .   *  #
#   $ @###
####$# ###
####   ###
##########
