##########
#  ####  #
#    .   #
#  #######
#. #     #
# .#  $# #
#     @# #
#   $$ $.#
#    ##  #
##########
