##########
####   ###
# $ $  ###
#  .     #
# ##  #* #
#  #    ##
# $#  @###
# .  #   #
#       .#
##########
