##########
#### $  .#
##   #   #
#   ###  #
# $##  ###
#   .    #
## ## @$ #
#   ## $ #
#.  ##. ##
##########
