##########
#   ###* #
# #   #  #
#   #$## #
###$  ## #
#. . $#  #
#     +  #
#   ## # #
#   ##   #
##########
