##########
#  #  ####
#        #
#  # . . #
####### .#
##  #    #
##$ $ @. #
# $ $#   #
#        #
##########
