##########
#  ##    #
#  ##  * #
# #####$ #
#  ###   #
#   . *  #
# $   @###
#    .   #
#        #
##########
