##########
###   .  #
###      #
###.  #. #
####    ##
#### #   #
#    $@$$#
# # ##$ .#
#   ##   #
##########
