##########
#####   ##
#  #   . #
#  # $ . #
##* # #  #
##   $ # #
##### @  #
# * ## # #
#        #
##########
