##########
#   #    #
#  $ $$$ #
##.   .# #
## ####  #
#        #
#    .@  #
####     #
####   . #
##########
