##########
##########
##  ###  #
#    $ $ #
#      #.#
## .# ## #
## .  @  #
###### $$#
######.  #
##########
