##########
##  ###  #
#   #  . #
#  .#  ###
##   #   #
# .    $ #
#    #@$ #
#   # $$ #
#  .    ##
##########
