##########
##   #####
##   #  ##
###    .##
### ###.##
# $ ###.##
# $$######
#@  ######
##########
##########