##########
#### $.*##
#  #     #
#    ##* #
##.#   # #
## #     #
## ###@  #
# $##  ###
#      ###
##########
uulluuurdldddrrdddlllluuu
