##########
#   ###  #
#   ###  #
#       ##
##### #$ #
#### . . #
####  @  #
#* * #$  #
#       ##
##########
rddluuluuurrddlddru
