##########
####   ###
##   #   #
##*##### #
##  #### #
###   #  #
##   .@  #
#  .  $$ #
# $  .  ##
##########
lddrrurullrdlllulldldrrr
