##########
#######  #
# *#  #  #
#. #  # ##
#$* # #  #
#    $   #
####  @  #
###  #   #
###  .   #
##########
llullludrrrrrdrruuldddrdll
