##########
###    ###
#  *#  . #
#  *###  #
#  ####$ #
#  #     #
#### $@###
###  #   #
###  .   #
##########
uruuddldlulddldr
