##########
#######* #
## *  # *#
##  # #  #
#  ## ## #
#      #*#
#  #  @# #
#   #    #
#       ##
##########
u
