##########
##       #
##  ###* #
#######  #
##### $  #
#  ##  * #
#   ##@.##
# #  .$  #
#     #  #
##########
rdlururuulddllurdrruuld
