##########
##  # * .#
#     *# #
#  ##  # #
########$#
#####  . #
#####$@###
####     #
####     #
##########
urruuudddllldrddllurdruulur
