##########
####   ###
##   #  .#
##     # #
# *#####$#
#* #     #
####  @#.#
####   #$#
####     #
##########
urruuddlldddrru
