##########
#  #   ..#
#     # $#
#  ####  #
#####   ##
#####$   #
##### @  #
#* ##.$  #
#        #
##########
ldrdruuuuuudrudldlldd
