##########
###     ##
#    .#  #
#   ### $#
##$ #### #
##    ## #
###  $+#.#
# * ##   #
#  ###  ##
##########
lulldrrullluulurrrurrrdrddd
