##########
####   ###
####$    #
#  . .   #
#  ### # #
# *###   #
#  ###@  #
##$$ #.  #
##       #
##########
