##########
#  ###   #
# *###  .#
# ####   #
#  ### # #
# $#     #
# $  .+# #
# #$  #  #
#        #
##########
