##########
##  .    #
## $ .#  #
#######  #
#     #  #
#$    #  #
# $#  @  #
#.$  .   #
#     #  #
##########
