##########
#   ###  #
#   #    #
###.#  ###
#   #$ ###
#   # *###
##    @###
#   # $  #
#..   $  #
##########
