##########
##########
#   ###  #
# * ###* #
# ###  # #
#  .#    #
#   ##@#.#
#     $$ #
##       #
##########
