##########
#    #   #
#        #
##.  # # #
####  .# #
# $ $#   #
#    $@# #
# # ## *.#
#   ##   #
##########
