##########
#  ####  #
#  ##.. $#
# ###  # #
#      # #
# *# # # #
####  @# #
#  # $ $ #
#       .#
##########
