##########
##  ###  #
##    #  #
####  # ##
#  #.$# ##
#  $ $ $ #
##    @. #
# .##  ###
#   .  ###
##########
