##########
## .  ####
#      ###
# . # .###
# $      #
##$##  # #
#   # @#.#
# $ #$   #
#        #
##########
