##########
##    #* #
##    #  #
###  ###.#
##    ## #
# $    #$#
#  ## @. #
#   #.$###
#   #  ###
##########
