##########
#####   ##
#  ##$.. #
#.     $ #
#######$ #
#    #.  #
#     @# #
###$ # # #
###      #
##########
