##########
#      ###
#       ##
# $# .   #
#  ## .# #
# $##  # #
#   # @# #
# $$  .. #
#  #     #
##########
