##########
#   #  ###
#   $  ###
#####  $ #
# $.##$# #
#   .    #
# ##. @  #
#       .#
#    #  ##
##########
