##########
#     ####
#.      ##
### #.#  #
##  #$ $ #
##  #.$  #
## .##@###
##   #$###
###    ###
##########
