##########
#     #. #
#    .   #
# ###    #
# ##  #  #
# $ $$   #
#   # @  #
### ## ###
### .$.###
##########
