##########
#  #  .  #
#        #
# *###  ##
###  ## ##
###   .  #
###   @  #
#  #$$   #
#   .  $ #
##########
