##########
#  #  #  #
#  #     #
#   #   ##
# $$### ##
# #.###  #
#. $  +  #
# $   .  #
##       #
##########
