##########
#### $. ##
# .$ .   #
#    ##  #
# ## #####
#  #     #
#  # $@$ #
##  ##   #
##  ##.  #
##########
