##########
####  ####
## $  #  #
## # $ * #
#   ###  #
#. .     #
##.#  @  #
#     $# #
#        #
##########
