##########
###   #  #
# $$$ #  #
#     ## #
# # #    #
# * ##  .#
# # # @ ##
#        #
## ..#   #
##########
