##########
## .  #  #
#    .  .#
#  #     #
## ####  #
## ## $  #
## # $@ ##
# $# #$ .#
#        #
##########
