##########
#   ###. #
#*# ###$ #
#       ##
####  ####
#    .#  #
#     @  #
# $$ #  .#
#        #
##########
