##########
# .      #
#  $#    #
##  #### #
#####    #
#  ##  * #
# .###@###
##   $   #
##.$     #
##########
