##########
#  #   ###
#.   #   #
##$ ###  #
#  $ . . #
#  $     #
##  ##@# #
###$ #.  #
###      #
##########
