##########
#        #
#  #    .#
#### ### #
#  #$    #
#  $ # # #
#$   $@# #
#   #   .#
#. ##   .#
##########
