##########
##  # .###
## .     #
####    .#
##  ###  #
##       #
##$$$ @  #
#   ## # #
#  .  $  #
##########
