##########
####  ####
##    ####
##   ##  #
####  #* #
#  # *## #
# $#  @# #
#   ## # #
#    *.  #
##########
ddlllulldrrrrllulluurddldrrr
