##########
#   ###  #
#  $$ #. #
##  $ #.##
#  #$    #
#        #
#   ##@###
# #  .   #
# .  #   #
##########
