##########
###     .#
#    * # #
#    ## $#
#  ####  #
#  ## $.##
#  ## +  #
###  #$# #
###      #
##########
