##########
######.  #
#  ###.  #
#  ###   #
# $ ### ##
#. .$    #
##$#  @  #
# $      #
#     #  #
##########
