##########
#   ###  #
#   ###  #
##$ ###  #
#  ##### #
#   #    #
#.$$# @. #
##   . # #
### *#   #
##########
