##########
####  $ .#
## .   $ #
# $ ###  #
#  ##### #
#  ##  #.#
#   # @# #
#  .## $ #
##  ##   #
##########
