##########
##    # .#
##   $   #
##### .  #
##  #### #
## $### $#
##    @ .#
###$    .#
###      #
##########
