##########
#    $ . #
#  # $  .#
#### #####
#      ###
# $ #.   #
#  ## @  #
#   ## $ #
#     .  #
##########
