##########
####     #
##..  $# #
##.      #
#  ##  $ #
#   # $###
#   ##@###
###  * ###
###   ####
##########
