##########
#  #     #
# *# # $$#
#      # #
##### $  #
###### . #
##### @  #
#  #     #
#.      .#
##########
