##########
####.  $ #
##.  # $.#
#   ###  #
#   ###  #
#   # $$##
##  # @  #
### .    #
###     ##
##########
