##########
#### * * #
##       #
# $  #####
# $####  #
#  ##    #
#    .@###
###    . #
###      #
##########
