##########
##. ###  #
#  .  #$ #
#  ## #  #
#.. # #$ #
##       #
##    @# #
### ##$$ #
###      #
##########
