##########
#  #  #  #
# .      #
#  #  .  #
#####  ###
#  ## $###
#* ###@###
##   $ ###
##   * ###
##########
