##########
#####    #
####  .  #
####  $###
#####.$  #
#####$ # #
####  @  #
# $  ..  #
#        #
##########
