##########
####  .###
#  #     #
#  ##. $ #
#* #  ####
# ## $ ###
#  #  @  #
## * # # #
###      #
##########
