##########
##  ###  #
#   $ #  #
#  .#.## #
#####  # #
#   $ $$ #
#   # @  #
#### .   #
####  # .#
##########
