##########
###   ####
### .$$ ##
###  . $ #
#  ##.#  #
#      # #
#   # @# #
# #.#$ # #
#        #
##########
