##########
##      .#
#.     . #
#    ##  #
#  #  #  #
#     #  #
#  # .@ ##
#$$$$# ###
#      ###
##########
