##########
#   ###* #
#   $ #* #
#  #  #  #
#   #. # #
#   #   .#
## ## @$ #
#      ###
#     ####
##########
