##########
##  ######
##  # .###
# $ $. ###
#  .$  ###
## #   ###
#.  ##@###
# # $    #
#    #   #
##########
