##########
#        #
# #  $ $ #
#     #$ #
##* ## . #
##  #    #
#####.@# #
# .      #
#     #  #
##########
