##########
####  #* #
#  #     #
# $   # ##
#. ####  #
#  #  #  #
# .   @###
#    $ $ #
#  .     #
##########
