##########
#      ###
#   # $$ #
###.# $  #
#   ## $ #
#   . .# #
##    @  #
###.#    #
###     ##
##########
