##########
##* # .  #
##     $ #
###$  #  #
##  #$ ###
##       #
##### @. #
#  .     #
#     #  #
##########
