##########
#  ##    #
# $# $   #
#  #   ###
#   $   ##
#  $#    #
### #.@ .#
### . .  #
###      #
##########
