##########
####   ###
#    #   #
#.  ###  #
#  #    .#
#.     # #
##$#  @  #
#   $$$###
#    . ###
##########
