##########
#  ##    #
#        #
##  #  # #
#        #
#*# $# * #
#     @# #
###$  #  #
###    ..#
##########
