##########
##     ###
#    #*  #
#   ###  #
#  .######
# # #  ###
#  . $@###
# # $$   #
# .  #   #
##########
