##########
#      ###
#  $$ $ ##
# $ ###  #
##  #   .#
##      ##
##  # @  #
#   #  . #
#   ..  ##
##########
