##########
#####  .##
##   . $ #
##*.$ #  #
###### $ #
#  #     #
#     @# #
#        #
#    #   #
##########
