##########
####  #  #
## $$.$  #
##  .  $ #
#   #### #
#  ##### #
#  #  @  #
#  . .#  #
#  #    ##
##########
