##########
#  ## *###
#   $   ##
#     #* #
# ##  ## #
#      # #
#     @# #
###  # * #
###  .  ##
##########
