##########
###      #
###$$  . #
### #### #
##  #   .#
# $ #    #
# $ ##@  #
# .  . ###
#      ###
##########
