##########
#  .     #
# $# $   #
#  ####  #
# $ #### #
#     #* #
##  . @  #
#     ####
# .  #####
##########
