##########
##  ###  #
# $  # $ #
# $#.    #
#. ##### #
#  ##    #
#     @# #
#    # #.#
# .    $ #
##########
