##########
#        #
#  # $$# #
#  ### #.#
#  ##  # #
#  ##.$ .#
#  ##*@# #
# #      #
#        #
##########
