##########
#  ##  ###
# $#   $ #
#  .  ##.#
# ###..# #
#  ### # #
#  ## @# #
# # $ $  #
#        #
##########
