##########
#  #######
# $ #    #
#.* # *# #
### ###  #
###   #  #
###.  @ ##
###   $  #
###  ##  #
##########
