##########
#  ###   #
#  ###   #
#  ### . #
##$#  #  #
#  *$.   #
#  $  @  #
### .  ###
###    ###
##########
