##########
#.       #
#   #$#  #
###    ###
#   # $  #
#.$ ##$  #
### # @.##
#     #  #
#  # .   #
##########
