##########
##  # . .#
##$ #   .#
#      ###
# ###   ##
#   #  $##
#   #.@ ##
###  #$$ #
###      #
##########
