##########
##   #   #
# .     .#
#  $ # ###
#.###.  ##
# ###    #
# ### @  #
# $ $  $ #
#    #   #
##########
