##########
#  ####. #
#.$ ###$ #
#        #
##### $# #
###### $ #
##### @# #
#   #  . #
#.       #
##########
