##########
#  .    .#
#        #
##  # #. #
#     ####
# $  $   #
#####$@$ #
####.  ###
####   ###
##########
