##########
##  ###  #
##    #  #
## *  ## #
##* ###  #
# $* #  ##
#     @  #
#    .#  #
#        #
##########
