##########
##  #  ###
##. $    #
####  #  #
#.  #  ###
#$# # .  #
#     @  #
# * ## $ #
##  ##  ##
##########
