##########
#  #     #
# *#$#   #
# ##   ###
# .    ###
# # #    #
# $ # @. #
# #$     #
#     # .#
##########
