##########
# *#  #  #
#  #.  . #
# ###  # #
#  ### # #
#. ###   #
# ####@# #
#$# $  $ #
#        #
##########
