##########
##  ##  ##
##$ # $. #
## .#    #
#     #* #
#   $ ####
#.##  @###
#   ##   #
##       #
##########
