##########
####    ##
#  # $   #
#    ##  #
####*    #
#  # $ . #
#   # @# #
# # * # .#
#        #
##########
