##########
#   $.#  #
# #$  #  #
#     $  #
### ##  ##
#   ##   #
# $ ##@  #
#.# ##.#.#
#   ##   #
##########
