##########
#  #     #
#  # #   #
#  #   ###
# ## ##  #
#  $$.   #
# *   +. #
# #$##   #
#        #
##########
