##########
# $    . #
# #$$  $ #
#   # ## #
##     # #
### #  # #
##. # @. #
##     ###
##  .  ###
##########
