##########
#   #    #
# #      #
# $.#  ###
## $ # ###
## $ $.###
#### #@###
#  #  .  #
# .      #
##########
