##########
###      #
###$###$ #
### ###  #
## $ $.  #
#    # # #
#     +  #
# #.     #
#      .##
##########
