##########
###      #
##    $$ #
##. ##   #
##  ###$ #
##  #  $ #
##.   +  #
##  #  ###
##    .###
##########
