##########
#      ###
# $ $#  ##
# $#     #
## #. # *#
#     # ##
#  #  @ .#
# #      #
#    .  ##
##########
