##########
##       #
##$ # $$ #
##. ###  #
##  ###. #
##    #  #
####  @# #
##### .$ #
######  .#
##########
