##########
##########
#  #.  ###
#  # $ $ #
## #  #  #
## #  $ ##
## ##$@. #
#   #  # #
#.    .  #
##########
