##########
#     .  #
#  .  #* #
##  ###  #
#     ## #
#  # $#  #
#  #  @$ #
#     #$ #
#  . ##  #
##########
