##########
#   #    #
#   #$$  #
### .  #.#
#  ####  #
#  #### .#
# ##  @$$#
# #   .  #
#        #
##########
