##########
#######  #
##       #
##. ######
#  #  # *#
#. # $   #
#  # .@###
#$$ ##   #
#        #
##########
