##########
#        #
#   # #  #
####  .###
#### *.###
####  $$ #
######@  #
##  #  ###
##  .$ ###
##########
