##########
#   . #  #
# $#$ #  #
#  #.  # #
###### # #
##       #
#     @  #
# .#  $$ #
#  .  #  #
##########
