##########
#     #* #
#  .     #
###    # #
#####    #
#####.  ##
#   ##@###
#* $ $ ###
#      ###
##########
