##########
#        #
# #$#.#  #
# .   .  #
## $#  # #
### #    #
##  $ @# #
#   # *  #
#   ##   #
##########
