##########
#        #
# $      #
# ##.$## #
# ##$* # #
#  #     #
#  ## @# #
#  #    .#
#    #  .#
##########
