##########
#        #
# .  $ # #
###  ##  #
#####  .##
##      ##
##$#  + ##
##. #$$  #
##       #
##########
