##########
#        #
#  #   $$#
#  ##  # #
###.$ #  #
##   $.  #
##  # @  #
####  .  #
####    .#
##########
