##########
#######  #
#     #  #
# $  *## #
#### ##  #
##  .$   #
##.#  @  #
# $### # #
#  .     #
##########
