##########
#### @ ###
#    #   #
# $$  #$ #
#  $#$ $ #
###...$###
##.... ###
##########