##########
#  #    ##
#    # .##
#  #### ##
## ###   #
## ##.*  #
## ## @$ #
#   # *$ #
#   ##   #
##########
lururrdllrrdddlluuddrruluuuu
