##########
#   ###  #
#   #    #
# ### .  #
#  ### ###
#  ## $  #
#   # +$ #
#*  ## ###
#  . $ ###
##########
ddllrruuuudrrdl
