##########
#     #  #
#   $ #  #
##.##### #
#  ##### #
#.$ #    #
##* # @#$#
###    #.#
###      #
##########
urrdullddllluuluuuurrrdlluld
