##########
##* ######
##  #. $ #
###      #
##  ######
# $ # *###
#.  # @###
###      #
###  ##  #
##########
dllluuuldrdluururrrrrull
