##########
##########
##       #
##  ###  #
#######  #
#* ####  #
#    .@#.#
#### * $$#
#####    #
##########
ddludrrrull
