##########
#      * #
#   #  # #
##*####  #
##  $    #
###      #
##  ##@. #
# * ######
#   ######
##########
ulllurrrdrruuldd
