##########
#### $ .*#
#    #   #
#   ######
##  ###  #
#   # $  #
#  ## @# #
##    #*.#
##      ##
##########
lurrurddulldldllluuuuurrurr
