##########
####     #
## .$ #  #
## *#### #
#   ###  #
#   #    #
## *# @###
##  ##*###
###    ###
##########
ururuuullldl
