##########
#######* #
#  #  #* #
#  #  #  #
#  ##  # #
#   #$   #
## .  @###
##.  $ ###
###    ###
##########
uuldrdllrrdlll
