##########
# * # *###
#       ##
## #  # .#
##  #  # #
##  ## #$#
##### @  #
# .  $ ###
#   #  ###
##########
dlllrrurrruu
