##########
#  ####  #
#  # .# .#
#        #
###      #
#  $$#.. #
#  $ $@###
###   ####
###  #####
##########
