##########
#.    $ ##
#    #   #
#  ####  #
####### ##
## * #   #
##    @  #
#  #* #  #
#*   ##  #
##########
uruuuulllll
