##########
#        #
#   ###  #
######## #
#**.###  #
#   # .  #
###   @# #
# $ ##$# #
#   ##   #
##########
urrdddlluulllddllurdruuu
