##########
#  # * ###
#    #   #
#  ##### #
# * ###  #
# # #.   #
#   # +# #
######$$ #
######   #
##########
urrdddlluuddrruldlurruull
