##########
#      ###
# *#     #
#######  #
#  ###  ##
#  .##  ##
## $##@$##
#    # $ #
#  #  .. #
##########
ddlluludrdrrrrululduuurddd
