##########
#  ##    #
# .$   $ #
## $  ## #
#  #  #  #
# $#  .  #
#  #  @ ##
# #  . ###
#    . ###
##########
