##########
#  .    .#
#  # #   #
####   # #
###    # #
###$.  $ #
### ##@#$#
#   ##$  #
#  .     #
##########
