##########
##### .$ #
#  # $ $ #
#  #  #  #
#   #  $ #
##     # #
##    @. #
#        #
#  #  ..##
##########
