##########
#  #  ####
#     #  #
##  ###  #
#  #.  # #
#    .   #
##$## @ .#
#   $$   #
#     $ .#
##########
