##########
## . #####
#   $    #
#  $$  . #
####   # #
## *# #  #
#     @  #
#  # #   #
#  .    ##
##########
