##########
# $   . ##
# $#     #
#  ##    #
#  #######
# .#    .#
# ## $@  #
#  # #$. #
#        #
##########
