##########
#  ####  #
#  ##    #
#  .#$$  #
##  #  # #
##  #   $#
### # @  #
# $ #  ..#
#     .  #
##########
