##########
#.   .   #
#       .#
#   ###  #
######   #
## $     #
## # $@  #
#   ##$$ #
# .     ##
##########
