##########
## .  #  #
##  $ #  #
## . ### #
## #$ ## #
## # . $ #
## ## @  #
#  ###$. #
#       ##
##########
