##########
###  ##  #
###    $ #
###    #.#
#######  #
#  ##   ##
# * #$@###
###.     #
### * #  #
##########
