##########
#      ###
#  #  .$ #
#  ##### #
####   # #
# *#   . #
# $ . @  #
# #$##   #
#        #
##########
