##########
##    #  #
# $    . #
#  ## $# #
#   ##   #
#   ##. ##
# ####@###
# *. $   #
##    #  #
##########
