##########
#.    #  #
#   $ #  #
# ###### #
#  ####. #
#  ##. . #
#   #$@$ #
#    $ ###
#  #   ###
##########
