##########
#  #   ###
#        #
##.      #
##  ## * #
##  ##$$##
######@$ #
#  #. .  #
#        #
##########
