##########
#   ##   #
#   $ .  #
### *  ###
# $ ######
# # ###  #
#     @  #
# #.#* # #
#   #    #
##########
