##########
#####   ##
# $ $   .#
# $   #  #
#  ## #  #
# $.     #
##  # @# #
#    .   #
#    #  .#
##########
