##########
##  ######
#  .###  #
#  ####  #
#  # * # #
#  # #   #
#.   $@#$#
#  #$#  .#
#        #
##########
