##########
#  ##  ###
#  #   *##
# ##     #
# ######.#
#    #.$.#
#     @# #
# #$   #$#
#   #    #
##########
