##########
#        #
# . ###  #
## #######
## # . ###
#     $  #
#   # @$$#
#  .   $.#
#  #    ##
##########
