##########
##  .    #
##       #
##  .##  #
#######  #
##. #  . #
#   $$@ ##
#  #$ $  #
#     #  #
##########
