##########
#   #  ###
# #    ###
#   # #  #
#*##    .#
#   .  # #
# $ # @#.#
##$$##   #
##       #
##########
