##########
##  #  ###
##       #
###   #  #
#   ### .#
#   #  # #
# ###$+  #
#  # $$  #
# *     .#
##########
