##########
##    #  #
#   . #  #
#  #  # ##
## ##$#  #
#        #
# .## @$##
# . # $$.#
#   #    #
##########
