##########
#  #*   .#
#     #* #
## #  #. #
##  ###$$#
##   #   #
#     @###
#   ## ###
#      ###
##########
