##########
#     #  #
#* #  . $#
####  ## #
#  ##  #.#
#  ## $  #
#  ##$@  #
# #      #
#    .   #
##########
