##########
#     ####
# $   #  #
###.###$ #
# $ $    #
#  .     #
#  ##.@# #
###  #   #
###.     #
##########
