##########
#       ##
#    #$  #
# ##     #
#  ####  #
#  #  # .#
#### *@# #
#   ## * #
#  . $   #
##########
