##########
#   # .###
# $ #  $ #
# .#     #
#   .### #
#  #     #
####  @# #
#    # $ #
# $    .##
##########
