##########
##### .  #
#  ##  . #
#  ### # #
## $ $$$ #
##       #
##  ##@# #
#   .    #
# .#     #
##########
