##########
####  #  #
## $.$ $ #
##     # #
#  ####  #
#. #     #
#  # $@###
#  .   ###
#.     ###
##########
