##########
#   ###  #
# # ###  #
#   .  # #
# ##  $  #
#.##  $$ #
# ### @ ##
# #.   ###
# $.#  ###
##########
