##########
##  #   ##
##  $  $ #
###   #. #
#   ###  #
#  # $ $##
#### .@ .#
###      #
###   .  #
##########
