##########
##########
#  ##    #
#    $.#.#
# $ #$ # #
#.$ # .  #
#  ###@  #
#   ###  #
#   ###  #
##########
