##########
#      ###
# #   .###
#   # ####
# #.#  ###
#     $###
# # # @  #
#.#   $$ #
# $  .  ##
##########
