##########
##   .#  #
##       #
####   . #
##  # ## #
# $    # #
# $ # @#.#
# #  $ # #
#    #.$ #
##########
