##########
####  # .#
##       #
##$#. #  #
#  .# ## #
# #      #
# $$$ @  #
### #    #
### .   ##
##########
