##########
#   ##   #
#    $   #
### $  ###
##  ###  #
# $$    .#
#     @. #
#   #    #
##.   . ##
##########
