##########
####   ###
#   $  . #
#   ##   #
#######  #
##. #. $##
##  # @  #
# $$#    #
# .      #
##########
