##########
##  ###  #
#    ..  #
#        #
##$ ###. #
## $  #  #
## $ $@ ##
#   ###  #
#  .###  #
##########
