##########
#  ##    #
#  .  .  #
# . #  # #
# ### #  #
# $      #
# $ # @.##
## $$  ###
###    ###
##########
