##########
# $.###  #
#        #
# ##   .##
# $   ####
#        #
#  #  +# #
# . # $$ #
#       ##
##########
