##########
#  #     #
# . $ #  #
#  #  #  #
######## #
# *##### #
#  #  @# #
# # ** # #
#        #
##########
ddrruuuuuuullldll
