##########
###  .  ##
##  $$  ##
##  #.# ##
####   * #
#        #
#.$ # @ ##
#######  #
#######  #
##########
