##########
#      ###
#  *#    #
# #####  #
# ##  ####
# *# $ ###
#  # .@###
##* ## ###
##     ###
##########
lluurd
