##########
#        #
#  # *#  #
########*#
#     ## #
#  #  $.*#
#  ## @###
####     #
####  #  #
##########
lur
