##########
##     ###
##  #    #
#####    #
##  #  # #
#*  #    #
#* ###@  #
# *  # ###
#   .$ ###
##########
