##########
#####    #
##. $  * #
##  #  ###
#  ### ###
#  ###* ##
# ####@  #
# $ . #  #
#        #
##########
