##########
#####  ###
#  ##    #
#  ###$$ #
##  #  # #
##  .  # #
##### @# #
###  .$. #
###   $. #
##########
