##########
#     ####
#  #     #
#  #  #  #
#####* ###
#####    #
######@$ #
### .. $ #
### *##  #
##########
urrddlllruurdrdll
