##########
####   ###
#* #     #
#* ####  #
##  .##  #
##  $  # #
###$ .@  #
###    ###
###   ####
##########
