##########
###  #####
##  .##  #
##   ##  #
### #    #
##   .$ ##
##*.# @###
###$$ #  #
###      #
##########
