##########
#     #  #
# $   # *#
# ## ## *#
#  # ###.#
#   .  #$#
##    @  #
####   ###
####  ####
##########
rrudllulllluluurrurddd
