##########
##########
##  #    #
# $      #
#  #######
#   .#.  #
## $ $@  #
#  ##$.. #
#        #
##########
