##########
#   ###  #
#   $.#  #
##### #  #
##  $    #
##  .# #.#
###   @  #
#.$ ##$###
#      ###
##########
