##########
#  #  ####
#  #  ####
# ##  #  #
#   # .  #
#  $# $  #
#. .##@###
#*$### ###
#      ###
##########
