##########
######  ##
######   #
######   #
## . # # #
##    $* #
#    #@$ #
# # . $###
#.     ###
##########
