##########
##  . #  #
##  $ #  #
#  $###  #
#    $  ##
##### #$ #
####  @  #
###  #   #
###.  . .#
##########
