##########
#######  #
## *###  #
# * #### #
# ###   .#
#.##     #
# ##  @ ##
#$ # $   #
#        #
##########
ddllllluuddrrrurdruuulurr
