##########
#######  #
#####    #
##### $# #
# * ## # #
#   ##   #
#.####@. #
# $ ## $ #
#     .  #
##########
