##########
##.$     #
## * #   #
##  ######
#  ##  ###
#.  #.   #
##  ##@  #
# $# $ ###
#      ###
##########
