##########
##       #
#   ###  #
#   ### $#
#####. #.#
##   $   #
##  # @#*#
### ##*  #
###     ##
##########
