##########
####### .#
####* #  #
#     #  #
#  ##$ # #
#    $ #$#
##  # @  #
#  .   ###
#.     ###
##########
