##########
### $  . #
# $ $$.  #
#   # #  #
#  #   # #
# . .    #
#   # @###
##########
##########
##########
