##########
##  #  ###
##  #  ###
#.  ## ###
# .  $ ###
##  #$ $ #
#####.@  #
#   * ####
#    #####
##########
