##########
###      #
#   # $# #
# . #    #
##$ #  # #
##  ##*$ #
##### @###
### . .  #
###      #
##########
