##########
##   ##* #
# $   #  #
#   $ ## #
#### .   #
##### ####
#### *@###
###      #
###     .#
##########
