##########
#######  #
##  .  $ #
## ##### #
##  #  # #
### $  $.#
##  # @# #
#   ## * #
#   .    #
##########
