##########
#        #
# # #  $ #
#   # .# #
#######  #
# *##    #
#.$ # @  #
###  # ###
###. $ ###
##########
ddllululrdrdrruuururuululd
