##########
####  ####
#  #  #  #
#  #     #
## ### ###
# .    ###
#. #  @. #
#$#  #$$ #
#     .$ #
##########
