##########
##  ######
##  .    #
####   # #
#  ##  # #
#. ##  $ #
#     @# #
#  $# $$ #
#.  ##.  #
##########
