##########
#  #######
#        #
## .  .  #
##.### ###
#   #    #
#   # @$$#
###  #$$.#
###      #
##########
