##########
#####. ###
#  #   ###
# .    ###
#  ## ####
#.       #
#   #$@$ #
# #  $$###
#  .   ###
##########
