##########
#      ###
#$$* #   #
#. ####  #
## ##### #
## ####  #
## # $@  #
# .#     #
#       .#
##########
