##########
####.  ###
#        #
#     ## #
####  #  #
##  .  $ #
##$#  @###
# *.# $###
#      ###
##########
