##########
#  ####  #
#  $ # $.#
#      # #
# .##### #
#    # $.#
##   .@###
####$  ###
####   ###
##########
