##########
#######  #
##    #  #
## $ $ # #
## ##  . #
#.  #$ ###
#   # @###
#    # $ #
#.  .    #
##########
