##########
#  $.#   #
# $      #
# ##$#  ##
# ##  ####
#     ####
#    .@###
##. ##*  #
##  ##   #
##########
