##########
##  ######
##  ###  #
##  ###  #
### ###  #
#.$ #. $$#
#   # @ .#
### $ # .#
###      #
##########
