##########
######   #
##### $  #
#   #    #
# #$# #. #
#  $ $ ###
# # . +###
#   .  ###
#  #   ###
##########
