##########
###     ##
# $ . #  #
# $ . #  #
#  #######
#. ##    #
# $#  @ .#
#   $  ###
#  #  ####
##########
