##########
##  ######
#   $ #  #
#.  # #  #
####  ## #
##    ## #
#     @# #
# .##$$ .#
# $.     #
##########
