##########
#  ####  #
#     # *#
## #$$   #
## #  # ##
#    $ . #
#  ## @  #
####  .###
#### . ###
##########
