##########
##    # *#
#     #  #
#   $## ##
#. #  # ##
#    .$ ##
#  ## @ ##
###.$ #  #
###  ##  #
##########
