##########
#  # .$.##
#     #  #
#  ####  #
# ##### ##
#  #   $ #
#  # $@. #
##* ##   #
###     ##
##########
