##########
#        #
# .   .  #
## #  ## #
# $$   . #
#   $  ###
## # $+###
#   ######
#   ######
##########
