##########
#* ##   ##
#   #  $ #
##  ###  #
## ####. #
##.#  #  #
## #  @$##
# $###   #
#   .    #
##########
