##########
#######  #
##.  #  .#
##     # #
#  ##### #
# .   ## #
#  #  @#$#
#   $$$  #
#  .    ##
##########
