##########
# .#######
#*  $.####
##  # #  #
#####   $#
#####    #
####  @# #
####   $.#
#####    #
##########
