##########
####. ####
####     #
####  #  #
####### ##
#     #$ #
#   $$@  #
# # .# ###
#   .$.###
##########
