##########
####  . ##
#### *   #
#     #  #
#   ##.$ #
##  #  $.#
##  # @# #
####  # $#
####     #
##########
