##########
#######. #
##   #   #
## # $ $ #
##  ###  #
### ###  #
##.   @  #
#* ##    #
#  $   .##
##########
