##########
#####.   #
#   #    #
# $ ## # #
# #### $ #
#   ##* ##
#.$ ##@###
#  .#  ###
#      ###
##########
