##########
#    ##  #
# $.  #  #
####  #.##
#####    #
######$  #
##### @  #
#    $   #
#. $ # . #
##########
