##########
###    ###
#    #   #
#  .   . #
#   ### ##
##   #* ##
#### $@ ##
#### *#$ #
####     #
##########
