##########
#####   .#
#   # $$ #
#      ###
#  ##  ###
#  # .   #
#..#  @$ #
#######$ #
#######  #
##########
