##########
## . ##  #
##   ##  #
###$ ## .#
#  $ #   #
#  $$    #
# ## #+ ##
#  #.  ###
#      ###
##########
