##########
#####    #
#  ##   .#
# .####  #
#  #### ##
# $#  #$ #
# .  $@. #
# # ## $ #
#   ##  ##
##########
