##########
####. $ ##
## $   $ #
## ###*  #
#   ###. #
# #      #
#     @###
##     ###
###  . ###
##########
