##########
####   ###
#   $  ..#
#   ##   #
#  #  ## #
# ##  $  #
#  ##.@  #
##* # $###
###    ###
##########
