##########
#######  #
## $. #$ #
## # .#  #
## ## #  #
## #.  . #
## #  @$ #
##     $ #
##      ##
##########
