##########
###   #  #
###   $  #
###   #. #
#####$#  #
#### $. ##
#  .  @###
#   ##*###
##     ###
##########
