##########
#   . #  #
# #   #  #
#. $ ## ##
###$ $ $ #
##   .   #
##  # @# #
#####  . #
#####    #
##########
