##########
#######  #
####  #$ #
####     #
#   $ ####
#   $$ ..#
# ###.@  #
#  #   ###
#.     ###
##########
