##########
####   ###
## $.    #
# *  ## *#
#  #######
#  # *####
#  #  @###
#    # ###
#      ###
##########
