##########
# * ######
#   #    #
## . $ # #
#  ##### #
#  .$ #  #
#* #  @  #
#   ##   #
##  ##  ##
##########
