##########
#  $.##  #
#   .##  #
##$  ### #
#  $###  #
#   $    #
#  #  +. #
######   #
######   #
##########
