##########
# $.######
#     ####
# ##  .###
#  ##   .#
#  ##    #
######@  #
# $.#  $$#
#        #
##########
