##########
####   ###
#  # .   #
# $##    #
#   # # ##
#   $    #
### # @. #
# $$     #
#.     . #
##########
