##########
#   ##   #
# $ ## $.#
# .### # #
#  .## # #
#   ##.  #
### ##@# #
###$ # #$#
###      #
##########
