##########
#   ###  #
#    #   #
#    $ ###
# ###  ###
#.*###   #
#  ## @  #
### $.#$.#
###      #
##########
