##########
#  #######
#  .#    #
##. #$#  #
##    #  #
##    #$ #
#### .@$.#
###   #$ #
###     ##
##########
