##########
##### .$ #
## .     #
##  # ##$#
####     #
##   $ $.#
##  #.@# #
####  #  #
####    ##
##########
