##########
####  .$ #
#  #  #. #
#  ####  #
#.  ## $ #
## $##  ##
##$ ##@###
#    .   #
#        #
##########
