##########
##     . #
## $* #* #
##  #### #
#######  #
##  #    #
#     @# #
#*# ###  #
#   ###  #
##########
