##########
##########
##    #  #
## ##$#* #
##  #  # #
#  . $ $ #
#.    @# #
#    .## #
#        #
##########
