##########
#  #     #
#   $    #
#   ##. ##
#######  #
##  #    #
#   # @###
# #* #   #
#  . $.$ #
##########
