##########
####   ###
####   $ #
#####*## #
##  #  $ #
#        #
#     @# #
#  .#    #
#.  ## * #
##########
