##########
####  #  #
#  #.$$  #
#  # .##.#
## # #   #
#       ##
#    #@###
####  $  #
#### .$  #
##########
