##########
####.$   #
#### $.$ #
#. $ ### #
#  #   # #
#  # #   #
#### .@###
#      ###
#      ###
##########
