##########
#    .   #
# $ $  $.#
###### ###
#      $ #
#  .     #
##### @###
### .  ###
###    ###
##########
