##########
##  ###  #
## $$ $$ #
##       #
#  ##.#..#
#  #     #
#  #. @# #
####     #
#####   ##
##########
