##########
#        #
#  $ # $ #
#. ####$ #
#  ###   #
#  ###  .#
#   ##+###
#$.  # ###
#      ###
##########
