##########
##   #####
##$   #. #
#  $  #  #
#  # #   #
# .# $   #
#### #@  #
####*    #
####.    #
##########
