##########
##########
#####.   #
#   # $  #
#   # #$ #
## # $ $ #
#     @ ##
# #   ####
#. ..#####
##########
