##########
##  ###  #
##.  #   #
### *    #
### ######
##    ####
##$ $ @###
# $   .. #
#    ##  #
##########
