##########
#    .####
# $   ####
#.$#######
# .      #
#####.## #
####  @# #
### $  $ #
###      #
##########
