##########
##  ###* #
##.   #  #
##  # ## #
#   #  # #
#   #  .*#
#   ##@$ #
##$ ###  #
##  ###  #
##########
