##########
#*  ###  #
#    *   #
## ####  #
# * ######
# # #    #
#     @  #
# #$###  #
#  .###  #
##########
