##########
##     ###
##   #.$ #
######## #
###  #   #
###  $ $ #
###. #@###
# *##    #
#  .     #
##########
