##########
##### *###
#        #
#     #  #
### ###. #
###  #   #
### $.@ $#
#   ##$ .#
#   ##  ##
##########
