##########
###     .#
#  $* .# #
# $ ## # #
###  . # #
###$ #   #
###   @  #
###    ###
###    ###
##########
