##########
#  #.  ###
# $      #
#    ### #
####$$ $ #
##  . . ##
##  #.@  #
##    #  #
###      #
##########
