##########
####*.#  #
#### .   #
#####  $##
##### #  #
##       #
## $  @  #
## $#. # #
##       #
##########
