##########
#       ##
#.   .#* #
#  ####  #
## #######
## #   ###
## #  @$ #
#     $# #
# *      #
##########
