##########
# *      #
#   ###  #
########*#
####  ##*#
##       #
#     @#$#
# # ## # #
#   ##  .#
##########
