##########
#  #  #  #
# ..  # .#
# $$  ## #
##  #  # #
##  ##   #
##### @#$#
###      #
###  ##* #
##########
