##########
#.   #####
#     #* #
#  # $#  #
#    $ # #
## ##$   #
# . # @###
#.  ######
#  #######
##########
