##########
#  ##  * #
#  ##*.$ #
#  ## *# #
#  ####  #
#  ##    #
#  ## @###
# #   ####
#    #####
##########
