##########
######   #
######   #
######   #
#  #. ## #
#  $  $  #
#. # $@  #
#  .#$ ###
#.     ###
##########
