##########
### $.#  #
## .  #  #
##  ### ##
#  .###  #
# . #    #
#   # @###
#   $ $$ #
#        #
##########
