##########
###     ##
###  #.$ #
###      #
######.###
#  .# $###
# $$# @###
#.#    ###
#   #  ###
##########
