##########
####  #  #
##  $.#* #
##   $ # #
####$  # #
#### #   #
#    .@###
#  # # ###
# .    ###
##########
