##########
#  ##    #
#  ## .  #
#   ## #.#
#    # $ #
#  #  $  #
####.#@###
#   $# ###
#   .$ ###
##########
