##########
#####    #
#* #  $$ #
#  #   ###
## #  $###
## # # ###
## #  @###
#      ###
#  .. .###
##########
