##########
#### * ###
#* #     #
#  ####  #
## #### ##
#   ###  #
# .   @  #
# #   $$ #
#.    #  #
##########
