##########
####*  ###
####    ##
####  #  #
##  #### #
##   # * #
####.$+###
### $  ###
###    ###
##########
