##########
#  ####  #
#.  ###  #
##.    # #
##  $$$  #
##.  #   #
###  $@###
#.    ####
#    #####
##########
