##########
##.   .###
## * #   #
####     #
#        #
#*#$# #  #
#     @###
## $   ###
###   ####
##########
