##########
####  ####
## .     #
##  #   .#
#######  #
# *##    #
#   # @$$#
### ##$  #
###    . #
##########
