##########
#   ######
# # ###  #
#      . #
#####$ ###
##  #    #
#   ##+  #
# $ . $$ #
#    ##. #
##########
