##########
# $   .###
# $. #   #
# ##### .#
#      # #
#  #     #
#### $@  #
#  # #$ .#
#        #
##########
