##########
#        #
#        #
#### ##  #
## * #####
##    .  #
#### $@ .#
#### $$ .#
####    ##
##########
