##########
#  $ .####
#  #  #  #
#  # $.  #
# ########
#  ## . ##
#. #  @  #
#$#  $   #
#    ##  #
##########
