##########
#  ##  ###
#      .##
##  #    #
## $#### #
##  ###  #
#### $@. #
# $. #$ .#
#        #
##########
