##########
#    ##  #
#  #.##  #
#### ### #
#  #$ #  #
#     $ ##
# . #$@  #
###$..   #
###  #   #
##########
