##########
######   #
# . *    #
#    $$ ##
#  #. ####
#  # $ ###
#     @###
#   .# ###
#      ###
##########
