##########
####  .###
#  #   ###
# $##. ###
# $ $ ####
# #. $####
#     @###
# #      #
#   .    #
##########
