##########
#   ###  #
#  * # .$#
#  #     #
####     #
##### #  #
#### $@. #
##    $  #
##   ## .#
##########
