##########
#* #..   #
#    * $ #
##  ###  #
### #  # #
## $#  # #
##    @# #
#### #   #
####    ##
##########
