##########
##.  $ ###
##   # . #
#######$ #
#   ##.  #
#   ## # #
## ###@  #
# .$ # $ #
#       ##
##########
