##########
##.   # *#
#  $     #
#  #  ####
#####$#  #
##       #
## #  @  #
#   ##.###
#.   $ ###
##########
