##########
####.  $ #
####   $ #
####.  #.#
#   ###  #
#   ###  #
# ##  @# #
#  # #$$ #
#  .     #
##########
