##########
####     #
#### .   #
####. ## #
#  ##  $ #
#   # $# #
##$ # @. #
# . #$ ###
#      ###
##########
