##########
#####  . #
####     #
#### $#  #
####   # #
#  # #   #
#..#  @###
#$*$ #   #
#        #
##########
