##########
####### .#
#  ##.   #
#  .$ $$ #
##  #  ###
## .  $###
##### @###
#  #   ###
#      ###
##########
