##########
#####    #
####  $. #
####  # .#
########.#
#####  $ #
####  @$ #
###   . $#
###      #
##########
