##########
####   ###
#.   # . #
#   ###  #
## ###   #
## ###$  #
##$###@  #
#   . $* #
#  #     #
##########
