##########
##########
##  .    #
##$ .    #
##  ##  ##
#        #
#  $$.@. #
# $#   ###
#     ####
##########
