##########
#   ######
# **     #
#   ###  #
# ##   ###
# ##.    #
# ### @  #
# #  #$$ #
#.      ##
##########
