##########
#  #######
#.$ ###  #
#.$ ###  #
### ##  .#
#   #   ##
#   #.@$ #
#   ##$  #
#        #
##########
