##########
##  ###  #
##$ $  . #
##. #### #
### ###  #
##   #   #
##    @  #
#  #$*#  #
#.   ##  #
##########
