##########
#   ###  #
#   .$   #
# ##   .##
#.## $#$ #
#  #$ .  #
#  #  @  #
#   ######
#   ######
##########
