##########
##  #  ###
##       #
##    #  #
##  #### #
##  # .  #
##### @$ #
#   #.$$ #
# .   $.##
##########
