##########
####     #
#        #
#   ##  ##
#.#   ####
#   *$ ###
# # #.@###
# #$ #$  #
#       .#
##########
