##########
###      #
### #* #$#
### ### .#
## ..    #
#   #  ###
#  ## @###
# # $$ ###
#      ###
##########
