##########
#  #    ##
#    #*.##
##  ###$##
######   #
#  .##$$.#
#   ##@# #
#        #
#       ##
##########
