##########
##  ######
##. #    #
##  #$#  #
#. ## #. #
#        #
#     @  #
## $ $ ###
### $ .###
##########
