##########
#  ##    #
#  #     #
#   $.#  #
#$$ #  ..#
#.  #    #
######@###
#    $   #
#    #   #
##########
