##########
##       #
##  ### $#
##  ###  #
##  #  #.#
##..  $* #
##    @###
###  $   #
###   #  #
##########
