##########
###   ####
##.$ $   #
##  $    #
###$ ##  #
#      .##
#     +. #
##       #
##   #   #
##########
