##########
##  ##   #
##  .    #
###.  .# #
### ## # #
##  #  $ #
##$ # @$ #
#   ## ###
#   .$ ###
##########
