##########
##  ##  ##
##     . #
###     $#
#  ##. # #
#  # .   #
#  # $@  #
##  # $$.#
###     ##
##########
