##########
##  #  ###
##$.#  ###
##  ## ###
#. .   ###
#$#    ###
#   ##@###
# *$## ###
#      ###
##########
