##########
####  #  #
##    #$ #
## #  #. #
## .##   #
##$ #  ###
#   #$@###
# # # $. #
#       .#
##########
