##########
#    * ###
#*# #  * #
#   ###  #
######## #
##  ###  #
##    @  #
#   *# ###
#      ###
##########
