##########
#        #
# $.#  $ #
# $ #  ###
# .###$###
#  ##.   #
##### @# #
#### .   #
####  #  #
##########
