##########
####  ####
####.  $.#
##### $ .#
#  ##### #
#  ##    #
#  # $@  #
#    # $ #
#  .    ##
##########
