##########
####     #
#* #$$## #
#  #  ## #
##     # #
##* #    #
### # +###
###    . #
###      #
##########
