##########
#   ###  #
#   ###  #
### .    #
### #  # #
##  # $$ #
##$ # @# #
# . ##   #
#  ###.* #
##########
