##########
###.     #
##    #  #
##$ ### ##
#  #     #
#$ $ $.  #
#. ## + ##
#   ######
#   ######
##########
