##########
#  ##    #
#  $  $  #
## ##   ##
##  ###$ #
### #   .#
##  . +  #
# *#   ###
#     ####
##########
