##########
#######  #
#  ## .$ #
#  # $.# #
#  # ### #
#  .     #
#  #  @#.#
#   ##$$ #
#   ##   #
##########
