##########
## *######
#   . #  #
#  #     #
#  ##### #
#  ####  #
#    *@$ #
## $  .###
##     ###
##########
