##########
##  ##.  #
#   ##*$ #
#  ###   #
##. #### #
#   $ #  #
#  $  @  #
##  #    #
##  ##. ##
##########
