##########
#     ####
#  $   $ #
### # #  #
# $$  #  #
#. .    .#
##### @# #
#### .   #
####    ##
##########
