##########
####   ###
#  # $ ###
#  ### ###
# ##  .###
#  #  .$ #
#  ###@  #
#  ### ###
# * .$ ###
##########
