##########
#   ###  #
# #.#    #
#   $   ##
# $$ .# ##
#  #    .#
####  @  #
###   ####
###* #####
##########
