##########
#   #. ###
#   #$ ###
#. ##    #
#  ###   #
#     *  #
#  .  @# #
#   ##$$ #
##  ##   #
##########
