##########
#   #  ###
#      ###
#####    #
# * ###  #
#    #   #
### . @###
####$$   #
#### . * #
##########
