##########
#  ##   ##
#  $     #
## ##    #
# $    ###
#       .#
##  ##@ .#
#*$##    #
#   .   ##
##########
