##########
###  .  ##
### #    #
### #  . #
## .   # #
#    #$# #
#* # $@# #
###### $ #
######  ##
##########
