##########
##########
##.   #  #
##   $#$ #
## ## #  #
#    $   #
#  ## +###
# # $    #
#    ..  #
##########
