##########
##       #
#   $ #$ #
#. ####  #
#    # $ #
#  # .   #
####.#@. #
#### #$  #
####    ##
##########
