##########
##### .###
#        #
#  *#    #
#   ###$##
##  #  $ #
##### @  #
#   .  ###
# .$ #####
##########
