##########
#. #     #
#   $ . .#
# $ # #  #
#   # ## #
#### . # #
####  @$ #
##   $ ###
##  #  ###
##########
