##########
###      #
###   # $#
### #### #
#    ### #
#* #   # #
####  @$.#
#   #  $ #
#.    .  #
##########
