##########
#   ######
#      ###
# ## * ###
#   # #  #
#   .$   #
####$ @###
##     . #
##.$ #   #
##########
