##########
#  ## $. #
#  $   . #
## # $.# #
#  ##### #
#  ##### #
#     @# #
##### *# #
######   #
##########
