##########
#####  $.#
#  ## .$ #
#  ####  #
#.##  #  #
#  . $  ##
#   # @###
# #$ # ###
#      ###
##########
