##########
#   ###  #
# $.###  #
#  .#### #
#* ## .  #
# $ #    #
##  ##@# #
##   #$# #
###      #
##########
