##########
#   ###  #
# #      #
# . ###  #
# $ #. #.#
#   #    #
####  @ .#
# $ $$#  #
#        #
##########
