##########
####  ####
#     #. #
#  $.##  #
## ## $ ##
#   #  $ #
# $ ##@ .#
###.   ###
###   ####
##########
