##########
#  ####  #
# .    . #
##       #
##. # #  #
##  .  $##
#### $@$ #
##### $  #
######   #
##########
