##########
#   ##  ##
#   ##   #
# ####.  #
#    #.# #
##    $$ #
#### #@$ #
#.    $###
#    . ###
##########
