##########
##    .###
##  #    #
#####    #
###. $ ###
##  $#  .#
##   $@. #
#### $   #
####  #  #
##########
