##########
####     #
##    #  #
##   *####
####  $  #
#  $ *   #
#   # +# #
##  ##  .#
###     ##
##########
