##########
## .   $ #
## $ # * #
###   .# #
######## #
##   #   #
##    @  #
####. $###
####   ###
##########
