##########
#     #  #
# ..$ #  #
### ###$ #
###  $  .#
##  # #$ #
##    @ ##
#   ##   #
#   .    #
##########
