##########
# $.###  #
#   #    #
# ##   # #
#      # #
# $ # .  #
#  ## @#.#
# $$     #
#    #  .#
##########
