##########
## $ .   #
#   #    #
#  #######
#   ##.  #
# #     .#
# $$  @  #
##$     .#
##   #  ##
##########
