##########
#        #
#*$####  #
# .####  #
##.##    #
## ##  . #
## #  @# #
# $# $   #
#    #  ##
##########
