##########
###    ###
## *#    #
##  #    #
### ###  #
#   ###  #
#   .$+###
#   ## $ #
## *##   #
##########
