##########
#. $ #  ##
# *  $  ##
#### #  ##
####  $###
## .   ###
##.   @###
#        #
#  #     #
##########
