##########
##  ##. .#
##  ## $ #
##  ##   #
###   ## #
### $$   #
###$  @  #
### #  ###
###. . ###
##########
