##########
###  #####
##   ##  #
##   ##  #
####  # ##
#### $.  #
#   $ @  #
#* # #   #
#  .$ .  #
##########
