##########
##  ###  #
#   .    #
#   ###  #
# ####  ##
# ##  $ .#
# ##.$@  #
# * #$ ###
#      ###
##########
