##########
##### * ##
##       #
##.#  #$$#
#  ####. #
#    # $ #
#     @  #
# # ## # #
#   ##  .#
##########
