##########
#     *  #
#   $$ # #
#####  # #
##     # #
## * # # #
####  @. #
#### .   #
####     #
##########
