##########
#####   .#
#####   $#
#   ###  #
#.    # ##
#.    #  #
###   @$ #
###   $ *#
###  #   #
##########
