##########
####  ####
##    ####
## #######
##  ######
### # $. #
##   $@. #
#   $#*###
#  #.  ###
##########
