##########
#  ###   #
#  .# .  #
##  #$ # #
##. #    #
##$$# .# #
##    @# #
#### $   #
####     #
##########
