##########
#   ######
#  $# *###
#      * #
##. #### #
#   #.   #
#  ## @  #
###    $ #
###      #
##########
