##########
#  ####  #
# .  # $ #
##$  $   #
##  ## ###
##  #  ###
##### +###
# .      #
#     .$ #
##########
