##########
####   ###
##     . #
##  ##$  #
##### $ ##
#   # .  #
# $ # +$ #
#  .#  ###
#      ###
##########
