##########
####   ###
#  #.$ $ #
#  * ##  #
## $ . # #
##       #
######@# #
#  ###   #
#    .   #
##########
