##########
#   #    #
#.*.$  $ #
###   ####
# * #  ###
#  ##  ###
######@  #
#   ##   #
#        #
##########
