##########
#  #### .#
#  ## $  #
#  ##    #
# . ##$# #
#  .## # #
## ###@#$#
#    *   #
#       ##
##########
