##########
#  ###.  #
# * ##   #
##  ##$# #
###      #
## $# ## #
##    @  #
###$#.   #
###  .  ##
##########
