##########
#######  #
#* #  #  #
#.     $ #
######  ##
#  ###  .#
#  ###@  #
#   # $# #
#      $.#
##########
