##########
##  ###  #
##  $.#  #
###   # ##
##  ##   #
#     .$ #
#  # $@###
###### * #
######.  #
##########
