##########
#### .#  #
#.       #
#    .#  #
#  #  .###
#$$ #  ###
#   # @###
### $$ ###
###    ###
##########
