##########
#       ##
# $$$#$. #
##  ..   #
#######  #
#.  ###  #
#     @  #
##   # ###
###    ###
##########
