##########
##########
##  #.   #
#    $   #
#  ####  #
#  #   # #
# *#$$+  #
###  # ###
###.   ###
##########
