##########
##########
#.$ #    #
#     .  #
######.#.#
##       #
## #  @$$#
#   ##$  #
#   ##   #
##########
