##########
#  .   ###
#    #.  #
#  #  $  #
####    ##
#####$#  #
#    .@$ #
# #*## ###
#      ###
##########
