##########
#       ##
#  #   $##
#. ###. ##
#  .  .$##
#  #  $$ #
######@  #
###  #   #
###     ##
##########
