##########
#  ####  #
# ..     #
#* $   ###
# $##*  ##
#  ###  ##
#  ## @ ##
####     #
####     #
##########
