##########
#   #  ###
# #.   $ #
#  .#.#  #
###   $  #
##    $ ##
##  # @###
#    #$###
# .#   ###
##########
