##########
#      ###
#  ..   ##
### ##   #
##.  ##  #
##     # #
### . @# #
### $$$$ #
###     ##
##########
