##########
###    ###
##   #*###
##  .  ###
##  ######
# $  .#  #
#*    @  #
# $    ###
#      ###
##########
