##########
####     #
#### $ $ #
#####  # #
#  # $#  #
#        #
#. ## @ ##
## .$ #. #
###    . #
##########
