##########
#..#     #
#       .#
#   #  ###
# $      #
##### #* #
####  @# #
#    $ $ #
#  #    ##
##########
