##########
#   ######
#   # .$ #
## #     #
##   #####
##  $.  ##
###$  @  #
###  #  .#
###.  $ ##
##########
