##########
####  #  #
## $   $ #
##  # ## #
##  # #  #
##  $ .  #
###.#.@  #
###$   # #
###    . #
##########
