##########
####  .  #
#### $ # #
######   #
#     #$ #
# .  $   #
## ## @###
#     .  #
#  #  #* #
##########
