##########
#   #    #
#  .$$ $ #
##.    ###
#   ###. #
#   ###$ #
##    @  #
###.## ###
###    ###
##########
