##########
#      .##
#   ###$##
#  #### ##
## #     #
## # #$ .#
##$# $@  #
#.  ##   #
#.       #
##########
