##########
## $ .  ##
##       #
#######  #
######## #
##### .  #
# *   @  #
# $$    .#
#       ##
##########
