##########
#######  #
#  #  #  #
# .#  #  #
##  # #$##
##  .    #
##  .$@$ #
#  .#  $ #
#   ##  ##
##########
