##########
##  ##   #
##  ##   #
##  ## ###
#. ##  ###
# $ #$   #
#    *+  #
#$  ##   #
#   ##.  #
##########
