##########
#######  #
#        #
#  $ $ # #
#.  ## # #
# .##    #
#  ## @# #
#$  ## * #
#  .##  ##
##########
