##########
# $.  #  #
# #  $   #
# . $.#  #
#####  # #
#  ### # #
#   # @# #
#     $  #
#  #  # .#
##########
