##########
##   ##  #
#   $  $ #
#* #$  # #
#    ### #
##     # #
##.   +  #
## .#  ###
##     ###
##########
