##########
#   #.   #
#   #    #
###  .  ##
#  #   ###
#  #  *  #
#   # +$ #
###  #$$ #
###      #
##########
