##########
#     #  #
#    .  .#
#   # $. #
######$# #
######  $#
######@# #
###* # # #
###      #
##########
