##########
#  #######
# .  .   #
#. #     #
##  #  # #
###*##$$ #
##  # @###
#   # $###
#      ###
##########
