##########
##########
#  ####* #
#  ####  #
##     # #
#     $  #
#$ #..@###
#.$##    #
#        #
##########
