##########
####### .#
####* #  #
#    .## #
#   #  # #
#   # $  #
#.##  @$ #
#$#    ###
#   #  ###
##########
