##########
#. #######
#$ ##    #
#  ## #  #
##  #  . #
# . #  # #
# $ ##@$ #
##   #*  #
###      #
##########
