##########
#######  #
## * . $ #
#   ###  #
#  ##### #
#  ## $  #
##### @$ #
###    # #
###   . .#
##########
