##########
####   .##
#  # $ $ #
#  ###   #
##.   #$ #
##     $ #
### # @  #
#   . .###
#      ###
##########
