##########
##       #
#   ###$ #
# *#### ##
# ##### .#
#   # $ *#
#   # @ .#
###  # ###
###    ###
##########
