##########
##### . ##
##  #. $##
## $##  ##
# . ## $##
#  $#    #
#   # @  #
# .  # ###
#      ###
##########
