##########
###   #  #
# $   .  #
#    .####
# ###$ ###
#  ##    #
#  ###+  #
###   $$ #
###   #. #
##########
