##########
#   ## *##
#  $ $ $ #
###   .  #
##  ###  #
##    #  #
#     @. #
#.       #
#  #  #  #
##########
