##########
#####  ###
##.     ##
##$##    #
#  .## $ #
#  . $ ###
#     @###
### ## ###
### $. ###
##########
