##########
#     #  #
# # $$$  #
#.  # #  #
##  # . ##
##$ #  ..#
##  # @  #
###      #
###      #
##########
