##########
##  ######
# $ #  ###
#      ###
# $####  #
# $. #   #
#  #  @  #
#  .#* ###
#     .###
##########
