##########
#  #     #
#.    #  #
#  #######
# ########
#.   # * #
#.   $@  #
#  #$$ ###
#     ####
##########
