##########
##* ######
#      * #
#  ####  #
######## #
#  #* ## #
#     @# #
# #$##   #
#    .  ##
##########
