##########
#  #  ####
#  #  $. #
# ### $. #
# ##  ## #
#* #  #  #
#. #  @  #
#$ #   ###
#     ####
##########
