##########
#      ###
#$#$#  ###
#.  #  ###
###    . #
## $#.#  #
##  $ @ ##
#   ##  .#
#  ###   #
##########
