##########
#   .  ###
# #    ###
#    ## .#
#   ###  #
# # ### $#
#    *@  #
### *$ ###
###   ####
##########
