##########
####   ###
#   $ .  #
# . ###  #
##$$  ## #
##. $ ## #
####  +# #
#   ##   #
#        #
##########
