##########
#  #   ###
#  #   ###
#  # #####
#$ #  ####
# $  $ ###
#.. $ @###
#### .#  #
####   . #
##########
