##########
##  #  ###
#        #
#  #  #  #
#######  #
#######  #
#     +*##
# . $* $ #
#    #   #
##########
