##########
###  $  .#
### # #$ #
###      #
#   ###* #
#   .#  ##
#  #$ +###
###    ###
###    ###
##########
