##########
####.  ###
#  # .   #
#* ## #  #
## ##  # #
## .  $# #
####  @# #
#### $ $ #
####     #
##########
