##########
####  ####
##.  .  ##
##  # #  #
##  #    #
###     ##
## $$ @$.#
#    # # #
#  #.$   #
##########
