##########
#  # . ###
#  #     #
# ### ## #
#   #$ # #
# # #    #
#  *##@###
###*.$   #
###   #  #
##########
