##########
##########
##    #  #
## #$  $.#
##     # #
### #.$  #
##. # @###
# $# .####
#    #####
##########
