##########
# * ###* #
#     #  #
### $.## #
##  #    #
# $ ##   #
#  ##.@  #
#        #
#        #
##########
