##########
##    #  #
##    .  #
## $# #  #
###.#  ###
##  #  ###
##  $ @###
###  $ $ #
###. #.  #
##########
