##########
#  #. ####
#  #  ####
#  #. #  #
#    ##$ #
#        #
####.$@# #
#    $# *#
#  #     #
##########
