##########
#    #  ##
# .#     #
# .# # $ #
#  .   ###
#  .# ####
###  $@###
####$ $  #
####     #
##########
