##########
###.     #
##    #  #
##    #  #
## ##    #
## ##  # #
## ###@# #
#*  ##$$ #
#  *##.  #
##########
