##########
#  #######
#  # * *##
#        #
# ###### #
# ###*   #
# ### @# #
#   ###  #
# $.###  #
##########
