##########
#* # .#  #
#* #   $ #
#   .  $ #
## ##### #
#     #  #
#     @  #
##  ## # #
###      #
##########
