##########
#  #### .#
#     #  #
#  ## # $#
## .# $ .#
#   # $ ##
#   # @###
###      #
###   # *#
##########
