##########
####     #
#  # $ $ #
#  ####  #
#   ##   #
#   ## # #
### ##@# #
# * .$ #.#
#    #  .#
##########
