##########
#     #  #
# * * #  #
# #####  #
#.$ ##   #
# $ ##   #
##. ##@###
###      #
###      #
##########
