##########
####     #
##  $ .  #
##.  ### #
##$####  #
#        #
#* # $@ ##
####  .###
####   ###
##########
