##########
###      #
#  $#### #
# *.###  #
####     #
####    ##
#.    @###
# #  # $ #
# $     .#
##########
