##########
# * .$ ###
# # #    #
#   ###  #
###    # #
#   .    #
#   # @# #
# $$# .  #
#        #
##########
