##########
#  #.    #
#    #   #
#      ###
#. ##  ###
#.###    #
#  ## @$ #
#  # $*$ #
#        #
##########
