##########
#   ######
#   ###  #
# ## $   #
#     #  #
#  # *##.#
####  @# #
#    $ #.#
#* #     #
##########
