##########
##########
#  #######
#    $.  #
#### #   #
#### *$  #
#    #+# #
# #   *  #
#    ##  #
##########
