##########
#      ###
#        #
#  ## #. #
# ###  . #
#  ###$$##
#  ## @  #
#### *# $#
####    .#
##########
