##########
##  .   ##
#   # # ##
#  #. $ ##
#  #  ####
#  # $   #
#  # $@#*#
##  #   .#
##  ##  ##
##########
