##########
#####   .#
##       #
##. #  ###
##  ######
##   #   #
#  . $@$ #
#   $ $###
#.  #  ###
##########
