##########
###  . ###
#  $     #
#  $. #. #
###$ ##  #
###      #
###$  @  #
##   # ###
##    .###
##########
