##########
##     ###
##   #   #
##  .  . #
##  # ####
##       #
###$ $+$ #
#  .## $ #
#  ###  ##
##########
