##########
###     ##
##  ### *#
##. ###  #
#      ###
# $  #*  #
####  +  #
#   ## $ #
#       ##
##########
