##########
###      #
##   # $ #
##  #### #
###.#### #
##       #
##    @$.#
#   #$$# #
# ..#    #
##########
