##########
######   #
##  ## # #
## .##   #
###    # #
#. $  .# #
#$$ #.@  #
#    #$###
#      ###
##########
