##########
#   ##  ##
#   ##  ##
# ####  ##
# .#.$ ###
#  # *$###
#  # .@  #
# $ ##   #
#       ##
##########
