##########
##  ###  #
##  #    #
###   . ##
##  ## $ #
##  ##$$ #
######@$ #
#.   .   #
#    #.  #
##########
