##########
# .    ###
# $ $    #
##### #  #
###  $ ###
#     .  #
#   ##@# #
######.* #
######   #
##########
