##########
#  #. #* #
#        #
## #   ###
## #  # .#
##.      #
##### @# #
### $ $$ #
###     ##
##########
