##########
## $ ..###
##       #
######   #
#####   ##
##  # . ##
#   ##@ ##
# $$*  ###
#      ###
##########
