##########
#  #  #  #
#.   $   #
##  # $.##
##     ###
## $# #  #
###  .@  #
###$#    #
###    . #
##########
