##########
##       #
#.       #
#. #. #. #
# ###    #
# $ #  $ #
#   ##@# #
### ##$$ #
###      #
##########
