##########
####     #
#  # # * #
# $$     #
#  #######
# $#  #  #
#  #  @. #
#   .  ###
#. #  ####
##########
