##########
# .     ##
# $$ $. ##
#  ###  ##
##  ### ##
### #. *##
##  # @ ##
#   #    #
#   #    #
##########
