##########
##  ###  #
##   #   #
###  * # #
#  ####  #
#   .# $.#
#  #  @  #
####  $.$#
####     #
##########
