##########
##  * ####
##    ####
##  ###  #
#* ###   #
#  #. $# #
#*##  @  #
#     ## #
##       #
##########
