##########
####     #
##   #  .#
# $$###  #
#  *     #
#  #   . #
######@  #
### .$ ###
###    ###
##########
