##########
#######  #
#####  . #
#####  $ #
#  #  #$ #
#   . .  #
##$## @###
#.  ## $ #
#        #
##########
