##########
##    ####
##     ###
#####  ###
#  .#$$###
#   #   ##
# .##.@  #
# $$ #   #
#       .#
##########
