##########
#    #  ##
#  # $ $.#
#### #  .#
###   #  #
###      #
### # @###
### ##$  #
### $..  #
##########
