##########
####    .#
####  #  #
#######  #
### . ##$#
##   $   #
## $  @# #
######.# #
###### * #
##########
