##########
##  ######
## .  #  #
###.     #
###  # # #
###   $$ #
###  #@# #
### # $#.#
###.   $ #
##########
