##########
####  .$ #
####  #. #
#######$ #
###  ##  #
###  $ # #
###   @$ #
#.       #
#   .    #
##########
