##########
##  #   ##
##  $ $  #
## $  #  #
# $###  .#
#        #
# .  .@  #
#   ## ###
# .    ###
##########
