##########
##  ######
#   #    #
#   #    #
##  ###$ #
##   #   #
### **@# #
###### #.#
###### * #
##########
