##########
###      #
###  #   #
### ######
#.  #    #
#   #    #
# $ ##@###
# #$ *   #
# .   #* #
##########
