##########
#    ##  #
# #$  #* #
# $   #  #
# .    # #
####     #
######@###
##    .###
##.  $ ###
##########
