##########
#     ####
#    $####
#  #     #
# . # #$ #
#  . $$  #
##  # @###
# ..######
#  #######
##########
