##########
##  #  ###
##   .  .#
##  #    #
###    ###
### # # .#
###   @$ #
###.##$$$#
###      #
##########
