##########
#  ####  #
#    # * #
## #$$   #
##  $  ###
##..     #
##  ##@  #
#    #   #
#  #    .#
##########
