##########
# * ###  #
# $.###$ #
# ## $   #
#    .   #
#### #   #
#### .@###
###      #
###      #
##########
