##########
####    ##
## .$. $ #
##  ###$ #
#  ### . #
#  ## $  #
##### @###
# .      #
#        #
##########
