##########
#######  #
####  #  #
####$ #  #
#  #   . #
#$     # #
#.$## +  #
#  ##    #
#.$      #
##########
