##########
####   ###
##.    . #
##  ###  #
### ###  #
#  $ $ $ #
#    *@# #
# . ###  #
#   ###  #
##########
