##########
####   ###
####$# ###
####   ###
####  #. #
#    .   #
# $ # @ .#
#.#$$ #  #
#    ##  #
##########
