##########
###     ##
# $.$  $.#
#  .# # $#
####  #  #
##    # .#
##    @###
#### # ###
####   ###
##########
