##########
####    ##
####  #$ #
#     # *#
#   ### ##
#   #  . #
## ##.@$ #
# $ ## ###
# .    ###
##########
