##########
#####    #
#   # .. #
#    .  ##
###### ###
######   #
######@* #
#    $$$ #
#    #   #
##########
