##########
#  ####  #
#  $.    #
##  ######
## #  . ##
## #  $*##
## ###@ ##
#   ## ###
#.   $ ###
##########
