##########
##  #    #
#   #* #.#
#  ##### #
##  ##   #
#  $ .   #
#  $. @  #
### $  ###
###    ###
##########
