##########
######   #
#  ###   #
#.$ ## # #
### ##   #
###  . ###
### $*@###
#  #   ###
#. $ #####
##########
