##########
##  ###  #
#   ###  #
# $##### #
#   ##   #
# . #* $##
### # @..#
#    # $ #
#        #
##########
