##########
#   #    #
#.  $  $ #
####  #  #
### *$ ###
#    . ###
#   # @###
###   .###
###    ###
##########
