##########
#  ####  #
#   ### *#
#    $   #
#  ##  ###
#  .# .###
## .$$@  #
### #  # #
###      #
##########
