##########
#.     ###
# #      #
#  .# #  #
### # ## #
##       #
##$ # @# #
# .# $$# #
#.     $ #
##########
