##########
##  ###  #
##   . $ #
## $####.#
#   ##   #
#   #  ###
# ###$@###
# .   *  #
##       #
##########
