##########
##   ##  #
##  $    #
## $    .#
####  #  #
#  #   ###
#     @###
##* ##   #
##  ##.$.#
##########
