##########
#  ####  #
# $####$ #
#        #
# .   ####
####$$#  #
####  @  #
###.   # #
### .   .#
##########
