##########
####  #  #
#  #  #  #
#  *  ## #
## #####.#
## ##  #$#
## ## @  #
# *  #*###
#      ###
##########
