##########
##   #####
#     #  #
#.   $#  #
####. ## #
#.    #  #
#     @  #
#  #  $$ #
# $    . #
##########
