##########
# * ######
#.  # *###
# ##     #
# ##.##  #
#  #     #
# $#  @###
#   # $###
#      ###
##########
