##########
##  ######
##       #
#### $ $ #
#   ###  #
#.    $$ #
## #. +  #
# .  # ###
#  #   ###
##########
