##########
#   ######
# $$ #   #
#  #  . .#
#  ####  #
#        #
## $$ @ ##
#### #.###
####.  ###
##########
