##########
#  #     #
#    # $ #
#  ####  #
###### $ #
#####  $ #
#. .#$@  #
#  ..  ###
#     ####
##########
