##########
#   ######
# * #  ###
###    ###
##* ###  #
# $ $    #
#   . @  #
###      #
### .    #
##########
