##########
#   ######
#  $ $ ###
#  #.  ###
#    .####
####  #* #
####  +  #
#   $ ####
#    #####
##########
