##########
#      ###
# . .    #
#   ###  #
##  ######
#   ### .#
#    $@  #
###$ # $ #
###.  $ ##
##########
