##########
# * ###  #
# # $   .#
#   ######
# $##  ###
#  #   $ #
#     @  #
# # #  ###
# .  . ###
##########
