##########
##  $.   #
#   $    #
# $ # #. #
#  ##  ###
#. ##  ###
# ####@###
#  ### ###
# $ .  ###
##########
