##########
##  #  ###
#        #
# .##   .#
# ### ####
# $      #
#  $$.+  #
#### $ ###
#####  ###
##########
