##########
#  . $ ###
#  # #  ##
####   $ #
##  #  # #
#   # $. #
#   ##+###
##  ## $ #
###.     #
##########
