##########
####  ####
##      .#
##$#$    #
# $ $  ###
# #. #   #
#.    @. #
#   ######
##  ######
##########
