##########
#####..###
##       #
## $#  $ #
##  ###$ #
###$#    #
##   .@###
##  .# ###
##     ###
##########
