##########
##  ###  #
#.$ #    #
#      ###
####  . ##
#. ## #$ #
# *# $@  #
#      ###
#  ##  ###
##########
