##########
####   ###
##      .#
## #  # $#
##  #$ # #
##  #  $.#
######@* #
###    #.#
###      #
##########
