##########
##  #   ##
##     $ #
##.   .  #
###### ###
##  ##$$ #
##  ##@  #
###*# .  #
###      #
##########
