##########
#  ## .  #
#   #    #
##  ###$ #
#  #     #
# . $# ###
##   $@###
## . $ ###
##.    ###
##########
