##########
#######  #
##       #
##$####  #
##.##  . #
##   $  ##
##### @###
### $ $  #
###.  .  #
##########
