##########
##     . #
##  ###. #
### ###  #
### *    #
##  #$   #
##$ # @ ##
#   #$.###
#      ###
##########
