##########
#  ##  ###
#  $    .#
#   # #  #
#  .#  $ #
##. #.$###
##  ##@###
#    $ ###
#   #  ###
##########
