##########
##  #  ###
## *#    #
#   ## . #
# #####.##
#   ###  #
#$   $@  #
#.  ##$  #
#   ##   #
##########
