##########
#        #
#.$ $ #  #
##. ### ##
####    ##
#  # #$ ##
#     + ##
# # ######
# * ######
##########
