##########
####     #
####  #$ #
#######  #
####  #  #
# . .$ .##
#  $# @  #
# #    # #
#  *     #
##########
