##########
##  # ** #
##   .   #
## $  ####
## ##  ###
## ### ###
## ## @###
#  $  .  #
#  #     #
##########
