##########
##    #  #
## $  $$.#
#####    #
####   # #
##     # #
#   . +# #
#   ##.#$#
#  ###   #
##########
