##########
####  ####
#  #  #  #
#  #  .  #
##  #  # #
# . #  $ #
# $###@# #
##  .$$# #
###    . #
##########
