##########
##  . ####
##     ###
###    ###
# ..# #  #
#        #
## $$$@# #
####  *  #
####  #  #
##########
