##########
#   . # .#
# .      #
## ## #  #
# $   ####
# $#$  ###
#  # .@###
# # $# ###
#      ###
##########
