##########
##    #  #
##    #  #
##  ###  #
# ..  $  #
#   # *  #
#. ## @# #
######$$ #
######   #
##########
