##########
#  .######
# $ ###  #
#        #
##### .###
##  # $. #
#   ##@  #
#   ##$  #
#     .$ #
##########
