##########
## .#    #
#   #    #
#   ##   #
# $ ###$ #
##    #. #
####  @#.#
#### $$  #
#### .#  #
##########
