##########
#      ###
#..  $ $ #
##   ##  #
# $##. # #
# .##    #
#  ## @$ #
##   # ###
###    ###
##########
