##########
#   #    #
#    $   #
# *#  #. #
#######  #
#######  #
####  @ ##
####.$$###
####  .###
##########
