##########
#######  #
#  #  #..#
#    .#$ #
#   #    #
# $ # $$ #
#  ## @###
####  .  #
####  #  #
##########
