##########
# *#     #
#    $#  #
#  #  ## #
# ##  .  #
# *# # * #
#  #  @  #
##########
##########
##########
