##########
####     #
#  # # * #
#      ###
#####    #
######$  #
##### +###
#    $ ###
#* # . ###
##########
