##########
#####.   #
#   #    #
#   #  ###
###.#   ##
##  .    #
##  # @  #
### $ $$ #
### * #  #
##########
