##########
####     #
####     #
##### #. #
#### $$  #
#### .$# #
######@. #
###### $ #
######.  #
##########
