##########
##      .#
##  ###  #
##  ######
#   .# * #
#    $   #
###  #@###
####. $$ #
####     #
##########
