##########
##.     .#
##  ###  #
##  ######
#   #  ###
#   .   ##
#  ## @$ #
###  $$  #
###   .$ #
##########
