##########
####  #  #
##      .#
## .#  ###
##  ## $ #
## $## * #
##  ##@  #
###$## # #
###     .#
##########
