##########
#   ######
# *      #
# ######$#
#      # #
#.   $ # #
## #  @#.#
#   ##   #
#   ## *##
##########
