##########
#### . $ #
##       #
## #######
##       #
## $*#   #
#     +###
#$# ######
#.  ######
##########
