##########
#    #####
#      ###
#  #  .$ #
######## #
#  ####. #
#$ #  @  #
#. # $ * #
#    ##  #
##########
