##########
##########
##    #  #
##    .$ #
#  ##### #
#. ##    #
# ..  @$ #
#    $$###
#      ###
##########
