##########
####  .###
##  . .  #
##  #  $ #
###$  ####
###      #
### #.@  #
# $$#  # #
#        #
##########
