##########
#####  . #
## .# $  #
# $ ##   #
#    ### #
####     #
#### $@# #
#.  .  $ #
#    #  ##
##########
