##########
####  ####
#  #    .#
#     #. #
#######  #
#  ####  #
# $ $ @$ #
# # ## $ #
#  ..   ##
##########
