##########
######.  #
##     ..#
##     ###
##  ###  #
###   #  #
##  .$@ ##
# $ ##$$ #
#        #
##########
