##########
##  ######
##  #.   #
##  $   .#
##  ## # #
### #.   #
##  # @#$#
#  $##$  #
# .     ##
##########
