##########
##  ######
##  $ #  #
##    #. #
### ###  #
# $  #   #
#   $ @ ##
###$  .  #
###.   . #
##########
