##########
#   #  ###
#   #   .#
#  ###   #
## #### ##
# $ $ #$ #
#   . @  #
###### #.#
###### * #
##########
