##########
##   #####
##$  #####
##   #####
#   ##   #
#   ## $$#
#   ##@. #
##   # * #
###.    .#
##########
