##########
#   ######
# #$$ ####
# .. .####
# $ #  ###
##$ #    #
##  ##@  #
##. ###  #
##  ###  #
##########
