##########
###  #####
###  ##. #
###.$##  #
#  $  # ##
# $ .    #
##  # @$ #
#   ##.  #
#   ##  ##
##########
