##########
##  #    #
#        #
#     # .#
######## #
#  #####$#
#  #  @  #
# $$* .###
#  .   ###
##########
