##########
##    ####
## $ .#  #
####     #
######## #
# .#     #
#  #  @  #
#*$ ##$. #
##       #
##########
