##########
##*    ###
#      ###
#  #######
##  #    #
##  #    #
###.##@# #
# *$##$ .#
#        #
##########
