##########
#####    #
#. ## $  #
#.  ###. #
#$$ ###  #
#    #   #
####  @###
#### $   #
####   . #
##########
