##########
##       #
##  #### #
#######  #
#### $   #
##       #
##*.##@. #
# $*##   #
#        #
##########
