##########
#####  ###
#  ##    #
#  #   #*#
## .     #
##     $##
##. ##@  #
###  #$$.#
###     ##
##########
