##########
### .   ##
###$$   ##
### # #.##
##  #    #
# . $$  .#
#  #  @# #
#   ###  #
#   ###  #
##########
