##########
##*    * #
##    #  #
##  #### #
####### .#
##   # $ #
## #  @  #
#  #  $###
#  .   ###
##########
