##########
####  #. #
## $ .#  #
## ####. #
##  ##  ##
## . $$ ##
####  @ ##
#### $ ###
####  ####
##########
