##########
##########
#####  ###
#####  ###
## .# #  #
## $ $ $ #
## $  +# #
##.      #
##   .   #
##########
