##########
#### $.. #
##   #$  #
##  $  ###
#### .#  #
## $    .#
## ## @ ##
##     ###
###  #####
##########
