##########
##  #    #
##  #  # #
##  #### #
# $$$   .#
#      . #
##  # @###
###.     #
###  ##* #
##########
