##########
# .   .  #
# $ $$## #
#  # .## #
#######  #
#  ####  #
#  # $@  #
##     . #
##  #   ##
##########
