##########
# .     ##
#   #   ##
#   ### ##
#  ##   .#
#   #  # #
##$ ##@# #
## *##$* #
###      #
##########
