##########
#####. ###
##.      #
#   # #  #
#  ##  $##
#  ##.   #
####  @$ #
#. $ #$###
#      ###
##########
