##########
##   #####
##* $##  #
### .##$ #
##  ###  #
##   ..  #
###   @###
#   ## $ #
#        #
##########
