##########
####### .#
#### .#  #
#### $# $#
####     #
#####$  ##
##### @ .#
##  #$   #
##     .##
##########
