##########
#       ##
#  ####  #
#  ####  #
####### ##
##   #   #
##   $@$ #
###$##.*.#
###    . #
##########
