##########
####     #
## .   $ #
##  ##  ##
#  #  ####
# ##   ###
#  ##*@###
#    $$. #
##   .   #
##########
