##########
##. .  ###
##       #
###  ### #
### ##   #
###   $$ #
###   @###
#  .## $ #
#    $  .#
##########
