##########
#    ##* #
#. $ . $ #
###    # #
#######  #
#####    #
#     @  #
# #$## ###
#   .  ###
##########
