##########
###   #  #
### $ # .#
### #### #
#.     # #
#    #   #
###.  @# #
###  $#*$#
###      #
##########
