##########
##. $ #  #
#   $    #
#  ## ####
##$ #    #
## ..$   #
##### +# #
###   #  #
###      #
##########
