##########
#  .  #  #
# $ $    #
### # *###
##  ###  #
##  $ #  #
##    +  #
#### #   #
####   .##
##########
