##########
###  ##  #
# .  ##. #
#    ##.##
#  #. #  #
# $#     #
#  ## @$ #
# $ ###$ #
#   ###  #
##########
