##########
##########
#####  ###
#. .   ###
# # # $ ##
# $ #$   #
# # # @ .#
#. $#    #
#   #    #
##########
