##########
##  .  ###
##  #  ###
### #  ###
#   ######
# #  .#  #
# $   +  #
# $#$#   #
# $    . #
##########
