##########
##   #####
## ** ####
####  ####
#   # .###
#   #$   #
#  . $@  #
#   ## # #
#   ##   #
##########
