##########
##########
#  #     #
#  #   $.#
## ## .###
## ###* ##
## ##.@$ #
#     $  #
#    ##  #
##########
