##########
#####  ###
#  ##   ##
#  ###   #
# #####  #
# ##  . ##
# ## $@  #
# $.# $# #
#. .   $ #
##########
