##########
###   .  #
###$# $  #
### ###  #
### #  . #
##  #  # #
##$   +# #
#.$ ##   #
#        #
##########
