##########
####  #  #
##    #  #
##   ## .#
## # ## .#
##     # #
####  @ .#
#    $$$ #
#* #  #  #
##########
