##########
##  ######
##  #   ##
### #$ $ #
## .   # #
## . .$  #
######@###
# * #  ###
#      ###
##########
