##########
######  .#
###### # #
######   #
#  *  ## #
# #$     #
#  $  +  #
# # $ #  #
#    ## .#
##########
