##########
##  ###  #
##. $ #  #
##   $ # #
### ##   #
### #    #
### # @# #
#  .##$# #
#.$ ##  .#
##########
