##########
# . ###  #
# $.     #
# $####  #
#      ###
####*#   #
####  @# #
#  ## $ .#
#       ##
##########
