##########
##    #  #
## $$    #
###  .   #
######## #
#####  #.#
#   $ @  #
#   $..###
#  #   ###
##########
