##########
####   . #
##    #  #
## #  #  #
#   ##  ##
#$#*## $##
# $ ##@ ##
# #  # ###
#..    ###
##########
