##########
#      ###
#.   # ###
## #     #
##$ # $  #
##   $$ ##
####. @###
####  .###
####.  ###
##########
