##########
##   #####
# .    $.#
#  #$$ # #
###. ##  #
#        #
# $  .@###
##########
##########
##########
