##########
#####  ###
#  ##  ###
#  ###.###
#  ###  ##
#.  #.$ ##
##$ #$@ ##
##    *  #
###  ##  #
##########
