##########
#   ###  #
# .  #   #
## #   ###
# $#.#####
# . $ $ ##
## # .@  #
#   ##$# #
#   ##   #
##########
