##########
####     #
#  #.* #$#
#    ## .#
#    ##  #
#  #    ##
#### $@###
####$#   #
####    .#
##########
