##########
##   * ###
##  .$.* #
######   #
####   ###
####   ###
######@###
# $    ###
#      ###
##########
