##########
###     ##
## $$   ##
##  . # ##
#  ####  #
#* ##    #
##### @#.#
###  # $ #
###   .  #
##########
