##########
##  #  ###
##  #  $.#
### .    #
####$.####
##   $ ###
## $#.@###
#   ##   #
#  ###   #
##########
