##########
####.   ##
#  #.#   #
#.       #
###  ##$ #
#    $ $ #
#   $ +# #
#######  #
#######  #
##########
