##########
###      #
### # .$ #
### ###* #
#     ####
# #      #
#   # @$$#
# # ##.#.#
#   ##   #
##########
