##########
##  ######
#.  #    #
#  ##$## #
# .   #  #
#.   $# .#
####  @  #
####$# $ #
####     #
##########
