##########
##### *###
#  #     #
#  #  #  #
#   # .. #
#   ##  ##
### # +###
### $ $$ #
###      #
##########
