##########
#  #  ####
#  $$  ###
## # ..  #
#  #  .$ #
#   # #$ #
##  . @ ##
#  ### ###
#      ###
##########
