##########
#####    #
##  #* #$#
##     # #
# .# ### #
#  #     #
#  #  @$.#
# #  .$###
#      ###
##########
