##########
##*.  $ ##
#   ###  #
#  ####  #
######   #
## .#    #
#   # @# #
# $ ##$ .#
#        #
##########
