##########
#######. #
#######$ #
#  * .   #
# # # ####
#  $     #
# #   @  #
#  $##  .#
#   ##   #
##########
