##########
#  ####. #
#  #### *#
# $     ##
# ##### ##
# ### $ ##
# ### @ ##
#$    #  #
#.   .   #
##########
