##########
##  ##   #
##  ##$ .#
###.##   #
# .$##$# #
#   ##   #
##$###@  #
##  #    #
###   .  #
##########
