##########
#####  ###
#####    #
#######  #
##     # #
##$  #.*.#
##   .@#$#
# $  #   #
#       ##
##########
