##########
#   ###  #
#   ###  #
### .$   #
### #  ###
### $  . #
###  $@. #
#### $   #
#### .#  #
##########
