##########
####  ####
# $   ####
# .   ####
#####$ . #
#####   .#
####  @# #
### $  # #
### .  $ #
##########
