##########
## .######
##  #    #
### # #  #
##  .    #
##* # #  #
### $ @  #
####$$   #
####   . #
##########
