##########
#  #######
#     # .#
## #  #  #
##  #* # #
#  *#  #$#
#  ###@  #
##  ## ###
##  .$ ###
##########
