##########
##########
#####    #
#####.#$ #
####   $ #
##     $ #
##    +###
###.## ###
### $. ###
##########
