##########
####    ##
####  #  #
#######*.#
#     ## #
# $      #
##### @$ #
###   $ .#
###  ##. #
##########
