##########
#####    #
##### $  #
######* ##
### $   ##
###  #   #
###   @ .#
#    .   #
# * #    #
##########
