##########
#####    #
#     .$ #
# $.# #  #
#####  # #
#  ##  $ #
#   # +  #
# #  # ###
#    * ###
##########
