##########
####  #  #
####* #.$#
#    ## .#
# *####  #
#  #  # ##
# ##$ @  #
# #      #
#        #
##########
