##########
#  .#    #
#        #
### $ #.##
#####$   #
#####    #
######@# #
### .$ # #
###  # * #
##########
