##########
#####   ##
##### $. #
#  .###  #
#      # #
## $     #
####  @#*#
#   $    #
#  #   .##
##########
