##########
#####.  .#
####     #
####  # ##
##### .  #
#  ##    #
#.$## @ ##
# $ $$ ###
#      ###
##########
