##########
####. ####
##    # .#
##.  ##$ #
## #  # .#
#     #  #
#     @$ #
### #  $$#
###      #
##########
