##########
#######  #
#  #  #  #
# $ $ $ ##
#  #  # *#
# ##. .. #
#  ## @###
#   #  ###
#      ###
##########
