##########
##       #
## *# $#.#
#####    #
######## #
#####    #
#     @  #
# $$  # .#
#      .##
##########
