##########
######   #
##* #    #
#   #  ###
#   * #  #
####    .#
##### @###
### *$   #
###      #
##########
