##########
#######  #
## *###* #
##       #
####   # #
#  #  .  #
#   # @# #
# # *# $ #
#       ##
##########
