##########
#   ######
# $ # *###
###    ###
##  # ####
#    .   #
# . # @$ #
#   ###$ #
#   ### .#
##########
