##########
#  .  ####
#  #    ##
####  $$ #
##* #$#  #
##      .#
###   +  #
### ## ###
###    ###
##########
