##########
#  # * ###
#     .$ #
#  * ##  #
# ###  # #
#  ##  $.#
#  ###@  #
#   #  ###
#   #  ###
##########
