##########
##########
##  ###  #
##    .$ #
# . #$$# #
#   #  # #
### #$@# #
#   # .  #
#  ###  .#
##########
