##########
#  #######
# *#  ####
# ##  ####
# ##    .#
#        #
#  $##+  #
# $* # ###
#      ###
##########
