##########
##      ##
##    #$ #
###.###  #
#  . #   #
#   . $$ #
###  #@ ##
###  #*###
###    ###
##########
