##########
# .   $  #
# #      #
#   ## $ #
####. $# #
#### # #.#
####  @#$#
###      #
###   . ##
##########
