##########
###      #
### # $  #
### #  # #
#.  #### #
# #.#### #
#     @# #
#   #$$$.#
#   .    #
##########
