##########
##  .  ###
##     ###
###   ####
#   #    #
#.$ # $. #
######@  #
# $ *  ###
#      ###
##########
