##########
####  ####
####     #
#        #
#*$$#### #
#. .#. # #
#  ## @  #
#####$ ###
#####  ###
##########
