##########
#  ##    #
#    .   #
## $  #  #
#### #####
##   $ . #
##  $$@. #
####.# ###
####   ###
##########
