##########
#  ####  #
#  ##    #
#  ## *###
##  # #  #
##       #
# .$# +# #
#   ##$$ #
#  ###  .#
##########
