##########
#   * ####
# *#  #  #
#  ####  #
#*###  # #
#. ##    #
#  ###@  #
#$#  #   #
#        #
##########
