##########
##.    ###
##      ##
# . ###  #
# .  .   #
##  # #$ #
####  @$ #
####  $$ #
####     #
##########
