##########
# * #    #
#*#  $ # #
#    $## #
##### ## #
####.    #
####. @# #
####     #
####     #
##########
