##########
##       #
##* # #$ #
##     $ #
### #  ###
### # .###
###   @  #
# * #.   #
#  ##    #
##########
