##########
#  #######
#  #  ####
# .      #
###### # #
## .##   #
##  ##+$ #
###$ #$$ #
###   .  #
##########
