##########
##########
#      ###
# $$.  ###
#.  ##   #
## ##.  .#
# $ # @ ##
#  $ #   #
#  #     #
##########
