##########
#      ###
#.#    $ #
#   #. # #
#  ####. #
#  ####$ #
#  #. @ ##
#$#   $###
#      ###
##########
