##########
####  #  #
##    # .#
## ##### #
#   ### .#
# $ # .  #
#  $  @  #
###$*# ###
###    ###
##########
