##########
#  #    .#
#  #.$   #
# ## ##  #
# *#   ###
#     $###
#  ## @###
#### $   #
####    .#
##########
