##########
#. #  #* #
#  $ . $ #
#      # #
# ###### #
#  ##    #
#  ## @  #
###   ####
###* #####
##########
