##########
##########
##  #  ###
##  #  ###
##$ #  ###
##  # .  #
## $  @  #
#  $  #. #
#  * .   #
##########
