##########
#######  #
#   ###  #
#      # #
#  ##  . #
#.  # $*##
##  # +$ #
### ##$  #
###     ##
##########
