##########
###.  #  #
#     #  #
# .   .  #
# # ######
#   ######
# #  $@###
# $$##$  #
#      . #
##########
