##########
#######  #
## *###$ #
#   ### .#
#  #### .#
#. #  $  #
# ##  @  #
#$#  #   #
#        #
##########
