##########
#  ###   #
# *### $ #
#  ### . #
# ###  # #
# ##   # #
# ##$ +# #
#    $ # #
##   #.  #
##########
