##########
#       ##
# $*# #* #
##       #
####  ####
#      ###
#     @###
### ## * #
###     .#
##########
