##########
#####  ###
#####   ##
#####    #
#.  ## #.#
# $ #  . #
##$ #$@# #
# $.   # #
#        #
##########
