##########
##  # $. #
##  $    #
##$$  ####
##  #    #
##.      #
####  @# #
#### . . #
####    ##
##########
