##########
##  ###  #
##  .#   #
### . .# #
####     #
##   $   #
##$ ##@###
#  $##   #
#     $. #
##########
