##########
##  ###  #
##  *    #
### ######
#   ###  #
# $.# $ $#
# ### @ .#
#     #. #
##       #
##########
