##########
#  #######
#     ####
##  $  $ #
## ####  #
#   # ...#
#  $  @ ##
#  .$  ###
#   #  ###
##########
