##########
####  # .#
##    #  #
##  #### #
##  #. # #
#   . $# #
# .## @#$#
#  # $$  #
#       ##
##########
