##########
#  #######
# $    $ #
#. #####.#
##. #  # #
# $ #    #
#    .@  #
# $ ## ###
#      ###
##########
