##########
#######  #
##    # *#
##$#    ##
#  $   ###
#  $# ####
###   @  #
#  #   # #
#..    . #
##########
