##########
##  #* ###
##     ###
#### $####
#### . * #
##   # # #
#     @  #
#  ###$###
#   .  ###
##########
