##########
#  #######
#   #    #
##  #  $ #
##  ## ###
##..##.###
##  ##@  #
#  $$    #
# .  $  ##
##########
