##########
#     #  #
#  #    .#
#  #     #
# #### ###
# $    ..#
# $   @$ #
###$. ####
###  #####
##########
