##########
#  . .   #
#   #  $ #
### ###$##
### #  $ #
##     $ #
##  . @# #
#.       #
#     #  #
##########
