##########
####   ###
##       #
##.#. #  #
##    ## #
##    .  #
##  # @$ #
#* ###$$ #
#       ##
##########
