##########
#  ####  #
#   $ #$ #
#  ##.#  #
##$ #    #
#.  # $# #
#   # @  #
#    #.  #
#     .  #
##########
