##########
##   . ###
##$ .    #
#   # #. #
# .#  #  #
# $$     #
#  ## @  #
#####$ # #
#####    #
##########
