##########
#  #     #
#.   #   #
#  ##### #
#   ###  #
#   # $$ #
## ## @  #
#  .  $$ #
# . .#   #
##########
