##########
#  #  #  #
#    $ * #
## ##$ .##
#  # $   #
#  # #  .#
# ##  @  #
#     #  #
#   .##  #
##########
