##########
## .######
## $###  #
###      #
########.#
#  ####  #
#  # .@  #
# # $$   #
# .    $ #
##########
