##########
#  #  #  #
#  #     #
#. ## ####
#     #  #
#  #$ #$ #
####  @  #
#   #$. .#
#  $.   ##
##########
