##########
#. ####  #
#.   #   #
#  # $$# #
#  ## $  #
#    .$  #
## #  @###
#    .   #
#     #  #
##########
