##########
#   #    #
# #      #
# * # #  #
# * #  #.#
##.      #
##### @###
####  $$ #
####     #
##########
