##########
#  ###  ##
#  $ $   #
##   . . #
# $ ###  #
#  $######
##    +###
#  .     #
#    ##  #
##########
