##########
#     .###
#   #  ###
##  ######
## ####  #
## #  $$ #
##.#  + .#
#    $##$#
#        #
##########
