##########
## .$ #  #
#.       #
#  ## #  #
###      #
#  $ . # #
#  $# @# #
# * #    #
#   ##  ##
##########
