##########
##     . #
#   # #  #
#      . #
##  .# ###
##       #
####$#@  #
# $   $$.#
#     #  #
##########
