##########
##  #.$ ##
##       #
####  # *#
#######  #
#    #  ##
#  .  @$ #
#   . $  #
##    #  #
##########
