##########
#    *.###
# $#  .  #
#  #$##  #
###  #  ##
# $     ##
#    #@ ##
#        #
#    ##. #
##########
