##########
#  #  #  #
#  *   $ #
## #  ## #
#. ##$ # #
#  ##  $ #
# ##  @  #
#        #
#..      #
##########
