##########
# . ### .#
#  $ #   #
#  .     #
#####  # #
#  ##  # #
#  $  @  #
#  $     #
#  *  #  #
##########
