##########
##  .    #
##$      #
# $ .## ##
# $$###  #
#   ###  #
# ##  @  #
#  .     #
#     # .#
##########
