##########
####   ###
##     ###
#   ##   #
# .##### #
# $##### #
#.    @$ #
# #  .$$ #
#.   #   #
##########
