##########
##  #. . #
#   #   .#
#   ###  #
### #    #
### $$  ##
### # @###
## $ $ ###
##.   ####
##########
