##########
##       #
##$$#$# .#
##     # #
##$    # #
#   #    #
#   # @  #
#  . .#  #
#  #  . ##
##########
