##########
#  #* ####
#.    . ##
## ## #  #
#   # ## #
#        #
#  #  @  #
#   ##$$ #
# $  .  ##
##########
