##########
######   #
##   $ $ #
## $$    #
### # ## #
# ..     #
#    .@  #
#. #     #
#        #
##########
