##########
#   #  . #
# # $ $* #
#   #  ###
#  ## $###
#  ##  ###
#     @###
#        #
#. .  #  #
##########
