##########
###   #  #
###  .# .#
###  ###$#
#   .    #
#       ##
# ###$@###
# $   $###
#. #   ###
##########
