##########
##  ###. #
#     #  #
#  #  #  #
###     .#
## $# #  #
##   *@# #
###$  $  #
###.     #
##########
