##########
##### .  #
#  ##   .#
#      ###
#  # . ###
#  # $ ###
#  ##$@$ #
#  .# $# #
#        #
##########
