##########
#     ####
# #  $ $ #
#   #  # #
#  .#    #
#  ##    #
####  @###
# $ $ #  #
#. .  .  #
##########
