##########
##  .$ ###
# * #    #
#  ##### #
# #    # #
#    #   #
# # . @# #
# $ ##   #
#   ## * #
##########
