##########
##########
#### .#  #
#     #  #
#  .#  # #
# # # $$ #
#  .##@$ #
###   .$ #
###      #
##########
