##########
##  #    #
## $   $ #
##    #  #
#####  # #
#####    #
#   # @  #
#** #. ###
#    . ###
##########
