##########
##  #  . #
## .#  $ #
###$#  ###
# $  $#  #
#  #     #
#  #  +  #
#    #   #
# .      #
##########
