##########
###      #
### ###$ #
### ### ##
### ##   #
#..  .$  #
#     @$ #
###  #.$ #
###     ##
##########
