##########
#   # *###
#       ##
#  .. #$ #
#  ##    #
#  ##  # #
#.### @$ #
# #  #$###
#      ###
##########
