##########
####### .#
##..###  #
##     #$#
#   # $  #
#   # $.##
##### @###
# $      #
#        #
##########
