##########
#        #
# $#   $ #
#* ## ####
#      ###
#### $  ##
####  +  #
#   .    #
#     . ##
##########
