##########
###      #
# $$$    #
# $   ## #
# ##  ##.#
#    .   #
#     @. #
#  #  .###
#     ####
##########
