##########
##  ###  #
##  .#   #
####    .#
####.    #
#   .# # #
#   $$@  #
####  $#$#
####     #
##########
