##########
#   ###  #
#.  $ #  #
##$#  #  #
#   #  # #
#.  #  $ #
##### @# #
# .      #
#     #* #
##########
