##########
####     #
##.  #   #
##  ######
##$#### *#
##       #
####$ +###
###  #$  #
###     .#
##########
