##########
#  #. ####
#  #$ ####
#  #   ###
# ####   #
#  ###.. #
#  ###@  #
#   # $$ #
#      $.#
##########
