##########
#     #  #
# $  $   #
#. # $ # #
# ###    #
# ####   #
#$### @  #
#    .  .#
##   .   #
##########
