##########
#   ######
#   ###  #
## ####$ #
#    $   #
# *#     #
######@  #
# .  $.# #
#  .     #
##########
