##########
#######  #
# *#  #  #
#   . ## #
## $#  $.#
##  ##   #
##### @###
## $     #
##  .    #
##########
