##########
####    ##
##    $ ##
## ##.  ##
##  ###$ #
##  #.   #
##### @# #
#.     $ #
#.  $ #  #
##########
