##########
####. ####
##     ###
##$ $  ###
#  #$ ####
# .  $####
#     @###
###   .  #
###.     #
##########
