##########
##########
#   #  .##
#   $   .#
#  #.  # #
#  # # # #
# *   @# #
###$$    #
###      #
##########
