##########
####     #
####$$ * #
#### ### #
#  # ##  #
#  #   $ #
# ##  @# #
#     .. #
#   #  . #
##########
