##########
#   ######
#*    ####
## #  ####
#  ####  #
#   . # .#
#.$#  @# #
# $ # $  #
#   #    #
##########
