##########
##    #  #
##       #
##. #  $ #
##  ###$ #
##  ###  #
###. $+# #
###  .$  #
###     ##
##########
