##########
######   #
#   ##$$ #
#  .## # #
### $  #.#
###$   # #
### ##+# #
#    # # #
#  .     #
##########
