##########
###   #..#
#     #$ #
#   ###  #
## #   # #
#     $  #
#  ###@# #
####     #
#### * *##
##########
