##########
####     #
## * #  .#
## ####  #
#  ####  #
#* #  .  #
#  #$ @# #
### $    #
###      #
##########
