##########
##  ######
##    ####
###  .####
#  #  # *#
#  .$   .#
#  $# @ ##
# # ##$  #
#   ##   #
##########
