##########
##########
##.   ####
##  # ####
##  #.####
##     . #
# .  $@# #
#   #$$$ #
#  ##    #
##########
