##########
###      #
#     #* #
#     ## #
# ###### #
#    . # #
# .$* @$ #
#   ######
#   ######
##########
