##########
####  #  #
####  #  #
####    ##
#  .# ####
#      . #
# $## +# #
# $  #$* #
##       #
##########
