##########
#######  #
#  #  #  #
# .#    ##
#    .$###
#  *#$ ###
#   # +###
###$   ###
###   ####
##########
