##########
######  ##
#####   .#
#####    #
###### ###
#  # $$###
# $#  @$ #
#   . ## #
# .#    .#
##########
