##########
#   ######
#   $    #
##   $   #
##### $###
#.  #  ###
#     @..#
#   ## * #
#   ##  ##
##########
