##########
# ..$ ####
#  #$ ####
####  ####
#####   ##
#  ##    #
# .## @  #
# $*#  # #
#        #
##########
