##########
#  #######
#   ###  #
#  $### $#
# #.  # .#
# $   . ##
#$#   @###
#.   #   #
##       #
##########
