##########
#  ###   #
#    .   #
#  #   ###
# $    ###
# $# # ###
#  #  +###
# $ # .###
#  . $ ###
##########
