##########
##  ##   #
##  # *  #
##  #  $ #
### #  ###
### ##$$ #
### # @ .#
###      #
### . . ##
##########
