##########
#  ###  ##
#.  # $ ##
##  #   ##
## #   ###
#. $ # ###
#*$#  @  #
##  ## # #
###     .#
##########
