##########
#  $ .   #
#  . $ $ #
####  ## #
######## #
##  #  #.#
##  # @  #
## $  .###
###    ###
##########
