##########
##. ###  #
#    #   #
#. .   # #
## ## ## #
##     $ #
#### $@###
####   $ #
#### $ . #
##########
