##########
#    #####
#  $ $ ###
###    ###
# * ##   #
#  #     #
####  @###
#   ## $ #
#   . . .#
##########
