##########
### * ####
##    ####
##. ######
##  $  $ #
##  # #  #
###$  @# #
#      . #
#  .  #  #
##########
