##########
#### .####
####    ##
#### .#  #
##  #  # #
#        #
# $$$ @# #
###.##*  #
###      #
##########
