##########
#  ####  #
# $ # $  #
#    . # #
### ### .#
##    #  #
## $$ +# #
####    .#
####    ##
##########
