##########
##### .###
##  .  $ #
## #     #
# .    ###
#  # #$###
#  # $@###
#   ##$###
# .    ###
##########
