##########
#  #   ###
#  $   ###
## ## #  #
# $ $$.  #
#        #
### # @ ##
#   #. ###
#  ##..###
##########
