##########
##       #
## $ #$# #
####  $  #
####  ## #
#  #   # #
#     @# #
###. .   #
###  # *.#
##########
