##########
#   #   ##
#*# * $  #
# * # #  #
##### ####
####     #
####  @  #
###   .  #
###      #
##########
