##########
#####  . #
##   $   #
##. #  # #
##$#     #
##       #
######@# #
# * ##   #
#      *##
##########
