##########
#       ##
# $      #
#####.  .#
####   # #
##   $   #
##$###@  #
#   ## ###
# .. $ ###
##########
