##########
#####.   #
##### $  #
######$  #
## $   $##
#   #   .#
#  ## +  #
#    # # #
# .      #
##########
