##########
######  ##
##  #.$  #
#   #  $ #
#  ## ## #
#  #   . #
#     @###
# #*##   #
#   ## $.#
##########
