##########
#####   ##
## . . $ #
##$.#    #
# $$ ### #
#        #
####  @# #
###   .  #
###     ##
##########
