##########
###      #
## .$ #  #
##  ### ##
####. #  #
####$ $  #
#     @ ##
# # ###  #
#   ###.*#
##########
