##########
#        #
#  $$ # *#
##  ######
#   ###  #
#   #    #
##. #.@$##
###.##   #
###      #
##########
