##########
#    ##  #
#  #     #
#  # .  ##
#  ##  ###
#  ###$###
#####*@###
#    * ###
#   $.####
##########
