##########
##########
#  .     #
#     $  #
#  ####  #
#  ##  # #
##### @  #
# $  * ###
#..  $ ###
##########
