##########
#   ..   #
#    #   #
###  $ ###
####$ ####
##   $####
#  .  @###
# # ##$  #
#   ##.  #
##########
