##########
#   .    #
#$$#  ## #
#. ##### #
##  #### #
##  #    #
#.  # +  #
#$# ## $ #
#   ##   #
##########
