##########
##  ###* #
#.*      #
#  #######
# ########
# .    ###
#     @###
##  # $$ #
###      #
##########
