##########
#   ######
#.       #
#  #### *#
##$####.##
##    #$##
####.$@ ##
#######  #
#######  #
##########
