##########
## .     #
##  $#$  #
### $  ###
## $## .##
#      .##
#  #  @ ##
#.   # ###
##     ###
##########
