##########
#  ####  #
#   ###* #
## $.  * #
#  #######
#     #  #
##    @  #
###$     #
###   . ##
##########
