##########
# *#   ###
#      ###
##.## ####
# $#  # *#
#  #     #
#  ##.@$##
###      #
###      #
##########
