##########
####  .$ #
##    ## #
#  * *## #
#  ####  #
# ###   ##
# *## @###
#   #  ###
#   #  ###
##########
