##########
#######  #
##  #  . #
#      $ #
#$#####$ #
# ## .  *#
#.##  @# #
#   ##   #
#   ##  ##
##########
