##########
## . .   #
## $$ #  #
##  #### #
## ##    #
##    .# #
####$ @# #
#  #  #  #
# .$ ##  #
##########
