##########
####### .#
##.$. #  #
## #  ## #
#* ####  #
#   # $  #
##    @  #
#  ###  $#
#        #
##########
