##########
###   ####
##  $    #
## .# #  #
##### .###
#.$ # $$ #
#     @  #
######  .#
######   #
##########
