##########
#.       #
# #  #.$ #
#  .######
#   ######
# # ######
#    $@. #
# $ ###$ #
#   ###  #
##########
