##########
##########
#  #  ####
# .    $.#
####$##  #
#  #  .  #
#   $ @  #
#   #$ ###
# .##  ###
##########
