##########
##### .  #
#  # .   #
#    $ ###
#   ##.###
# $ ##$ ##
### ##@  #
###$  .  #
###      #
##########
