##########
#   ###* #
# $    $ #
# .####$ #
#  #     #
#    # ###
##  . @###
####  .  #
####     #
##########
