##########
#  .  #  #
# $#    .#
#  ##   ##
#####  ###
#####  ###
######+* #
#### $ $ #
####     #
##########
