##########
##       #
## $ $ . #
##### ## #
####   # #
#  #   # #
#.$###@# #
#   #  # #
#.   $ . #
##########
