##########
#   ######
#  .$ #  #
###. *   #
####$  ###
####     #
######@  #
# .  $ ###
#      ###
##########
