##########
##     ###
##   # ###
####   ###
#  ###$ ##
# $##   .#
#  ##.@  #
#   ## $ #
#  .   * #
##########
