##########
#  ####  #
#  #  #$ #
#    * . #
#   ## ###
#   #    #
# ###.@  #
# $ ###$ #
#.  ###  #
##########
