##########
##  ### .#
##* * #  #
####   # #
###### # #
#  ###   #
#   ##@  #
##* ## #$#
###      #
##########
