##########
# .  ##  #
# $#  .  #
#  #    ##
######   #
####     #
#   $$@###
#   # $###
#.   . ###
##########
