##########
#  # .$ ##
#    #  ##
#  #### ##
## #  #  #
# $ $.#  #
#.  $ @ ##
####     #
####  .  #
##########
