##########
#######  #
#####    #
#####  # #
#  . ### #
# $  $ $ #
##$#  +  #
#   .    #
#  #.    #
##########
