##########
##     ###
##   $ ###
##  #   .#
#.  #### #
#$ #  ## #
# $#  @# #
#. #   $ #
#.   ##  #
##########
