##########
##########
##  #    #
# $ # ##.#
#   #  # #
##  #.   #
##  ##@* #
#  ###$$ #
#  .     #
##########
