##########
#   ######
#    #   #
## .     #
#  $ #####
#  #   ###
####..@  #
###  $ $ #
###* ##  #
##########
