##########
#    #####
#   .  $ #
#  # $ $ #
##### ## #
#### *   #
####  @# #
#  ##..  #
#        #
##########
