##########
#  # .#  #
#        #
#.*##    #
###  # ###
# $ $  ###
#  $ #@###
# # #  ###
#     .###
##########
