##########
#######. #
##  ###$ #
##       #
#  ##  ###
#  ##  ###
#### $@$ #
# $.  #  #
#  ..    #
##########
