##########
##       #
#  .  . .#
# $ ######
###  #####
###  $ ###
###$$ @###
###     .#
###      #
##########
