##########
#######  #
#  ####  #
#      # #
## $#  # #
##  ##   #
### #.+  #
#  *$    #
# .  $   #
##########
