##########
##########
#  .   ###
#   . $###
##  #  ###
#   # $###
#    $@$ #
#   #  # #
# .  .   #
##########
