##########
####  #  #
#  #  $  #
#  # $  .#
# ## $####
# ##$  ###
# ##  @###
#  # .#  #
#. .     #
##########
