##########
##  ######
##       #
#      . #
# .#######
#. #   ###
#   $$@###
#  * $   #
##   ##  #
##########
