##########
##  ###**#
# .  #   #
#  #   ###
#  ##  ###
# $ #   .#
##    @  #
###$     #
###  ##  #
##########
