##########
###      #
##  # $$$#
##. ###  #
##.    $ #
##  # # .#
####  + ##
####     #
####     #
##########
