##########
#     .  #
#     .  #
#######  #
####. # ##
####$$ $##
####  @ ##
#   #$.###
#      ###
##########
