##########
#   ######
#  $######
#  $ $ ###
##$#.#.###
#  .     #
#  # #@# #
#  #    .#
#       ##
##########
