##########
####...  #
####  #  #
#######  #
####  #  #
#  #     #
# $ # @ ##
#   $$$  #
#  .#    #
##########
