##########
##  ######
## $###  #
## .     #
#####*$# #
##  ##.  #
## .# @$ #
#        #
#        #
##########
