##########
###    ###
# $$$# ###
#     $ .#
#   ##   #
#### .. .#
####  @# #
###      #
###      #
##########
