##########
####.$ ###
## $ . ###
#        #
#  #### .#
#. ####  #
# ##  @# #
#$ # $   #
#        #
##########
