##########
#  #  #  #
# *   #  #
# *#  ## #
# ##### .#
# #####  #
#*##  @# #
#  $     #
##       #
##########
