##########
###  #####
###  #####
###  ##  #
## ..##  #
##    $$.#
###.$ @ ##
#  # #$###
#      ###
##########
