##########
#  ####  #
#  ## $$ #
#.###  * #
#.  # #$ #
#    .   #
##  # @# #
####  ## #
####     #
##########
