##########
####  ####
####.  ###
#####  ###
#   #  ###
#   $. ###
#*$*# @###
#     #  #
#        #
##########
