##########
####  #  #
##   .#..#
#     #  #
# $ ###$ #
##   #   #
####  @#$#
##  ##   #
##     * #
##########
