##########
###   ####
## $  ####
##  . .  #
##  #  # #
## $     #
#   # +# #
#*# $ #  #
#    ##  #
##########
