##########
#* #  ####
#  .  #* #
##   $   #
#   #  ###
#* ### ###
##### @  #
####  #  #
####     #
##########
