##########
#######  #
##  ### .#
##$ ###  #
#  .#  #$#
# $.#$   #
###   @###
#  .   ###
#      ###
##########
