##########
#   ###* #
# $ ###  #
### #### #
##  ###  #
##  * $  #
###   @ .#
#  ###   #
#.      ##
##########
