##########
##     ###
##   # ###
####   ###
#  ##.####
#   .    #
# .## @$ #
# # $$## #
# $  .   #
##########
