##########
####  ####
## ..  ###
##  #    #
##      $#
#.     # #
#  ## @$ #
##   #$$.#
###     ##
##########
