##########
####  ####
## $   ###
##  $$ ###
#  ## $  #
#  ###   #
# ### @# #
#   .  . #
#.    .  #
##########
