##########
#   #  ###
#   $    #
##  #.#  #
### #    #
###$  .  #
###  .@###
#.$$   ###
#     ####
##########
