##########
#   ###  #
#   ###  #
#  ####  #
##$#  $* #
#   ..$  #
# .###@  #
#   ##   #
#   ##  ##
##########
