##########
#   . #  #
#  $$    #
##$#  .###
## ##$####
#  .     #
#  #. @  #
#   ######
#   ######
##########
