##########
##   #####
#   $.#  #
#  #  #  #
#####  . #
##  #  # #
# $ ##@# #
# # * $# #
#  .     #
##########
