##########
#  ####. #
#  #     #
# . $ . ##
#  $###  #
#  $  ## #
###   @  #
#  ### ###
#    * ###
##########
