##########
#  #     #
#     #  #
##  ###. #
#######$ #
#  #   * #
#    *@# #
#### #  *#
####     #
##########
