##########
##     ###
##  .    #
#    ##  #
#  #. #$ #
# .  $ $ #
# .$# @  #
#   ######
#  #######
##########
