##########
###   #  #
##      .#
##$ .  #.#
## $#  # #
# * #    #
#   # @  #
# $ ######
#   ######
##########
