##########
###   ####
## $ $ ###
## .# *###
#. ## ####
#      $ #
#  #  @  #
#  ###   #
#      .##
##########
