##########
####  #  #
#### *  .#
#    $# ##
#  ##    #
#  ##  . #
#   ##@ ##
### $.$###
###    ###
##########
