##########
####  # .#
#### $#  #
####. .  #
#####$ # #
#####  * #
#   ##@# #
#    # $ #
##      ##
##########
