##########
### .#   #
## $  .  #
## $ # $ #
## ####  #
## #   ###
## # .@###
# $    ###
#  .   ###
##########
