##########
#  #    ##
#    #   #
## #### $#
#* ##### #
# .    #.#
## # $@# #
#  #$ .# #
#    #   #
##########
