##########
###      #
##    # $#
##. ###  #
#   ###*.#
#   #   ##
## ## @###
# $ ## $ #
# .      #
##########
