##########
#   ##   #
#   #    #
#  ##  # #
##  ## # #
### # *# #
## .#$+# #
##   $ * #
##      ##
##########
