##########
#  #     #
#  #  # .#
# . ### $#
#  $$ #  #
# .  $  ##
#  ## @###
## .   ###
###   ####
##########
