##########
#######  #
####  #* #
####   * #
#  ### ###
#$ ###  ##
#  ###@  #
#.$.##   #
#        #
##########
ddllllluruuuldd
