##########
##     ###
##*  #   #
# * ###  #
# * ######
#.  ###  #
# ## $@  #
#        #
#   #   ##
##########
