##########
##  ###  #
##  ### .#
###      #
######## #
#   # .  #
# $ $$@  #
##  . *  #
###   #  #
##########
