##########
###    ###
### .  ###
### #  ###
##    .  #
##  #.   #
#####$@# #
####  $$ #
####   * #
##########
