##########
#      * #
#* #   # #
#  #####.#
######   #
#   ## $ #
#   ##@#*#
# # ##   #
#       ##
##########
drruuulldrurd
