##########
####     #
#  #  #.$#
#   $ #$.#
#   #*.  #
##  #  ###
##### @###
####     #
####     #
##########
