##########
##  ######
##  #  ###
#.   $ ###
#  # $$  #
#  ##    #
#*### @###
#   #    #
##..     #
##########
