##########
#######  #
#  ##.   #
#  ##  $ #
#  $  ####
##$  $ ###
##  # @###
#    # ###
# ..  .###
##########
