##########
#        #
#  # #$  #
#### $ . #
#######. #
#  ## *# #
#  ##*@# #
##  ##   #
##      ##
##########
