##########
##  # *. #
##  # $* #
###    # #
####  ## #
##   . # #
##    @# #
###$ #   #
###     ##
##########
ddllluulurruuruurlddru
