##########
#####    #
#####    #
#       ##
#   ###  #
#   ### $#
## #. @ .#
#  $$*.###
#  #   ###
##########
