##########
#   ######
# * ###  #
# #####$ #
#   ##   #
#    .$  #
##    @$ #
#      ###
#  . . ###
##########
