##########
#  #  #  #
#   * #  #
## ##### #
#  #   # #
#* # .   #
# ####@# #
#. $ #$# #
#  #     #
##########
urrdddlluuddrruuulldddllull
