##########
####     #
#  #  $  #
#  .  # .#
# ###### #
#  ##### #
#  # .@# #
# #  $ #$#
# * #    #
##########
ddludrrruuuuuluurdllluldrdl
