##########
#   ######
# # ###. #
#   ###  #
##$ ###$ #
## . #.  #
####  @###
# *# # $ #
#        #
##########
