##########
####   ###
#    $ ###
#  $* ####
###   .###
##  #  $ #
##. # @  #
#      ###
#.     ###
##########
