##########
###  #####
##.  #####
##   #####
#.  #    #
#  ## $# #
#  ## @$ #
# .   $# #
# $   .  #
##########
