##########
#######  #
#* ##    #
#        #
#######.##
#  ####  #
# $# .@  #
# $ *    #
#        #
##########
