##########
#####. ###
## *  $ ##
#.$   #  #
# #####  #
# $      #
#     @  #
#  # # ###
#    . ###
##########
