##########
#     ####
# # $.$. #
#     # *#
### # .###
##  ## ###
##  # @###
#### $ ###
####   ###
##########
uuluurlulldrdrdrddddllurdruuu
