##########
###   ####
### $.#  #
###   #  #
## .#   ##
# $ #   ##
#  ###@ ##
# $      #
# *     .#
##########
