##########
##       #
## $# *$ #
###.###  #
##   ##$ #
##       #
####  @###
#  .  .###
#    #####
##########
