##########
##########
##########
#      ###
# $.# . ##
# #      #
#. .# @$ #
#   # $$ #
#        #
##########
