##########
##    ####
#     ####
#  #   ###
######   #
##   $$  #
##$#  @  #
# .*## # #
#   ##. .#
##########
