##########
##########
####  #  #
#        #
#.$ ##   #
##* #    #
#####$@###
#   .  ###
#  #* ####
##########
uldrdluuruullldl
