##########
####  #  #
## ..   .#
##  #  . #
#####  # #
##  #$$# #
##    @# #
#   ##$$ #
#  ###   #
##########
