##########
#       .#
#  #* #  #
#  #  ####
# $ ###  #
#  .###  #
###   @# #
###  * $ #
###      #
##########
