##########
#     #  #
#  #     #
##### #  #
### . #  #
### $*####
###  .@###
#####$   #
#####  * #
##########
