##########
##    #  #
##  $ #  #
##   ## ##
# $##    #
# . #* $ #
#   #.@###
#    #   #
#.       #
##########
