##########
#   ### *#
#    #  *#
#  #   ###
## *###  #
#   #    #
#  #  @  #
# #    ###
#. $ #####
##########
