##########
#     #  #
#  *  $  #
#  #$$   #
####   # #
#####    #
#   #.@# #
#      . #
#. #  #  #
##########
