##########
#   ###  #
#***###  #
###      #
##  ###  #
#   #### #
#  # .@# #
###    $ #
###      #
##########
ldrdrrulldlu
