##########
#   #. ###
# #$#$ $ #
#      # #
# $ ####.#
#.  #    #
#  ## @# #
#      # #
#.       #
##########
