##########
#  #   ###
#  #  .###
# $ ## ###
#. $.   ##
##$.     #
##  # @  #
# $ ##   #
#        #
##########
