##########
#. ####  #
#.$    $ #
#  ##### #
#  ####  #
#$$  #   #
#  #  @###
#.   # ###
## .   ###
##########
