##########
#  ##   ##
#   * ** #
#   # #* #
##### #  #
#  #    ##
#  #  @###
#        #
#        #
##########
d
