##########
#  ##  ###
#. . $ $ #
#   #    #
#   #### #
#####  # #
####  @$ #
#        #
# *#.   ##
##########
