##########
##  #. ###
##  .$   #
###$#    #
##  ## # #
##  # $# #
#   # @# #
#  .##$ .#
#   ##  ##
##########
