##########
##   #####
##    . ##
#      $ #
# .### $ #
# .   $  #
##   .@###
###$ # ###
###    ###
##########
