##########
####    ##
#. # # . #
#        #
#       ##
##  # #  #
## $  @$ #
# .*##$###
#      ###
##########
