##########
#####   ##
##  #   ##
#   ### ##
#$# # .  #
#   # $$.#
#.# ##@ ##
#   #  ###
# .  $ ###
##########
urldddllluuuuulldd
