##########
######  ##
#  #     #
#  #     #
##  #### #
# * #### #
#     @# #
# # $#.$ #
#   *.   #
##########
