##########
#######  #
#######  #
####   # #
#  #   # #
#     $# #
# . ##@#.#
#  $  $  #
# .# $.  #
##########
