##########
#### .  ##
##      ##
##$$# # ##
#  .#$  ##
#   #    #
# $###@  #
#.  ##  .#
#   ##   #
##########
