##########
#######  #
#    #   #
#   .$  ##
####   ###
##   $* ##
#   # @ .#
# #$##  .#
#   ##   #
##########
