##########
#  #* *###
#     .  #
#  #.$   #
##$ ######
##    ####
###   @###
####     #
#####    #
##########
lullluulurrrrrdlrrrul
