##########
#    .#  #
#.  $ #  #
# ##     #
#   #  $ #
##  #   ##
######@###
#    *   #
# *  ##  #
##########
ururulldluulll
