##########
#  ##    #
#        #
##*##  ###
#   ######
# * ###  #
# ##  +$ #
#  # $  .#
#    #  ##
##########
rurdlllldrurrddlu
