##########
#   ###* #
#*# #    #
#   #  ###
## $#    #
##       #
##. # @# #
#   ##   #
#  ### * #
##########
ulllluurdldrrrurrdlllluld
