##########
###   # .#
#    .   #
#     #  #
#######. #
#   #    #
#  . $@  #
###$##$$ #
###      #
##########
