##########
#        #
# #   #  #
#   ###  #
#..#  ##.#
#  # $#  #
# $#. @  #
# $ ## $ #
#        #
##########
