##########
####### *#
##   #   #
##     #*#
####  #  #
# *#     #
#  #  @# #
# #   #  #
#  * ##  #
##########
l
