##########
#######  #
## *###  #
##       #
#### $$###
#* # #.  #
#.    @# #
####  ## #
####     #
##########
lluuurrdluldddrddlurulll
