##########
##  #**  #
#   # *  #
#  ###  ##
#   ### .#
#     ##$#
#     @  #
### ## ###
###    ###
##########
rru
