##########
#   ###  #
# * #    #
##     ###
####     #
#   # #  #
#    $+# #
######*# #
######.$ #
##########
lllulldrrrruurrdrdddl
