##########
#  #   * #
#     ## #
##  #### #
#*  ### .#
#   #  . #
#  ## @  #
##### $$ #
#####    #
##########
lddruulurddrdruuu
