##########
#    #####
#   $#####
## . #####
#  #$$ ###
#  . $   #
##  ##@  #
#   #   .#
#   .    #
##########
