##########
## .######
##$ #   ##
## .  .  #
##  ###  #
# $  #   #
#  $  @ .#
# $ ##   #
#   ##  ##
##########
