##########
####    .#
##  . $  #
## *### ##
#######$ #
#    #   #
#     +###
# #$##   #
#        #
##########
