##########
#       ##
#  .# $$##
#  #### ##
## ####  #
## ## $  #
##$#  @ ##
#     #. #
#  #. .  #
##########
