##########
#  .  ####
#      $ #
#  #  #* #
#####  # #
#####    #
######@ .#
#    $ ###
# *#   ###
##########
