##########
#   #    #
# . #  # #
## ##### #
##$.#    #
##  #*  ##
###$##@###
#. $ # ###
#  #   ###
##########
ddllullruuluu
