##########
##  #.   #
##  . .  #
####  #  #
######   #
##       #
##$#$ @  #
#   $$.###
#   #  ###
##########
