##########
#######  #
#  ####$ #
#  ####  #
#     #  #
#  .   .##
# ### @###
#.  #$$  #
# .$     #
##########
