##########
#  #######
#     #  #
##  #$# .#
###.  #  #
## $     #
##  $ @..#
# $ ##   #
#   ##   #
##########
