##########
##       #
##   # * #
##       #
## ####* #
#   #### #
#     @  #
#### $#* #
####   . #
##########
ldldrr
