##########
#  ##  ###
#    . $ #
## # *#  #
# * #### #
#   #  # #
##### @  #
##  ## ###
##.  $ ###
##########
ddlllrrruurruuuull
