##########
#######  #
####  #  #
#        #
# * ####.#
#  # $   #
####  @  #
#   ## ###
#  * * ###
##########
llurrrdru
