##########
#####  . #
#  #    .#
#  # $ ###
##  #  $ #
##* ##$  #
#   # @  #
# #   .###
#    #####
##########
