##########
####  #  #
##    #$ #
##     * #
#   #### #
#   #    #
## .# @###
#### .$  #
####. $  #
##########
