##########
#  #     #
#    #   #
#  #   ###
##  ######
#   . #  #
#  # $@ .#
# $ $# ###
# .  * ###
##########
