##########
##  ######
##  $ ####
##. # #  #
####  #* #
#        #
# $.# @###
# * ##   #
#  ###   #
##########
lulllldrurruruulluld
