##########
#  #  #  #
#  $  $  #
#   $ #  #
### ###  #
##  .  ..#
##  . @ ##
###  $   #
###      #
##########
