##########
#   .  $ #
#  #.$ $ #
######## #
#   ###  #
#    #  .#
###   @ ##
### #$ ###
### .  ###
##########
ldrdluurururuuulllrdlrrurddd
