##########
#  #  #  #
# *#     #
# ##     #
#     # ##
# *#   $##
# *## + ##
# #    ###
#      ###
##########
