##########
#  #  #  #
#     #  #
#. #. ## #
#  # ### #
#  #   $ #
#### *+$ #
###  #$# #
###      #
##########
