##########
####   ###
####     #
######  *#
##  ###  #
##  ###* #
##    @#.#
#    #.$$#
#        #
##########
ddrrul
