##########
#######  #
#   ### .#
# $ ###  #
#  #   # #
# $$$   .#
#     @  #
#  .   # #
#  .#    #
##########
