##########
###   ####
#   .   ##
#     #  #
##$ #  # #
##  #  #.#
######@# #
###    #$#
###*.$   #
##########
ddlrrruuddlluuuulullddluulurr
