##########
##    #  #
#   . #* #
# $#     #
##  #  ###
# $ #  ###
#.  # @###
#$#  .   #
#        #
##########
