##########
###      #
#  $ .# .#
#   ### $#
#####.   #
# . $  ###
# $ # @###
### ## ###
###    ###
##########
