##########
#    #.  #
#.       #
###  # # #
##  ## $ #
## .##$* #
#   ##@# #
#   ## $ #
#  ###  ##
##########
