##########
######   #
##  # $  #
#   #    #
#   ###  #
## $ # . #
##*$  @# #
##   #   #
##. .   ##
##########
