##########
##  #   ##
#   #   ##
#   ## .##
#  ##  ###
#  ## $###
# *###@###
##   #$  #
###  *.  #
##########
duuuuruulldrurd
