##########
##########
#  #   ###
# $#   . #
#  ####  #
#  ####$ #
# .  *@  #
#   ###* #
##  ###  #
##########
