##########
##  #    #
#  $ $   #
#   . ## #
#. ####  #
#  ##.   #
####  @$ #
#    $.###
#    #####
##########
