##########
##* #  ###
##  $$.  #
### $    #
### #### #
#   ..## #
#     @  #
#   #    #
#   ##   #
##########
