##########
#######  #
#####.   #
####  .# #
#   $ #  #
#   $    #
#  ##$@ .#
# #    # #
# $. #   #
##########
