##########
#####  ###
##  #  ###
##. #    #
#    .   #
# $ # ##.#
#  #  @  #
# $$ #.$ #
#        #
##########
