##########
#  #     #
#  # #   #
# ##*  *##
#  #### ##
#   ###*##
#   . @ ##
###$   ###
###    ###
##########
ddlllurululldrr
