##########
##########
#  ##    #
#  ## #$.#
##  #    #
#   ##*  #
#  ## @# #
##   *#* #
##      ##
##########
ururuulddrdluuullddrrdru
