##########
#   ### .#
#  .     #
#  ####  #
#   ##   #
# # # $  #
#.  #*@  #
# # $ $  #
#       ##
##########
