##########
# *## *###
#      ###
#  ## ####
####     #
#  # *   #
# *###@###
# #  #   #
#        #
##########
u
