##########
##  ######
##  #  ###
### *  ###
##* # #. #
##       #
###   @$ #
#  #$.## #
#        #
##########
lddluururrrdlluldllurrrdru
