##########
###   .  #
###  . # #
###   #  #
### #  $ #
###.#  $ #
### ##@$##
#        #
#    ## *#
##########
