##########
##  ######
##    #. #
#### .$  #
#######  #
#   ###$##
#    $@. #
#   ##$# #
#   ##.  #
##########
ruuulrdddldullldllurrrrr
