##########
#  #    ##
#  #  #  #
# ##### *#
#  #  #  #
# *#    ##
# ### @###
#  ###$$.#
# .      #
##########
drdllll
