##########
#      .##
#   . #  #
#  # .#  #
#  .#### #
# $ #### #
##   $@# #
# $#$#   #
#        #
##########
