##########
####   ###
##     ###
## # #####
#  #  #  #
#  # *** #
# ##  @###
#   ## $.#
#   ##   #
##########
dr
