##########
####  #  #
## *  #  #
## # ##  #
##     #*#
#        #
#   ##@# #
###      #
### *# * #
##########
d
