##########
##     ###
##       #
#### ### #
####    .#
#### $$ ##
##### @###
#.$ ##.###
# .  $ ###
##########
lulurrrllddrddlllulrdrrruuluurdd
