##########
###   #  #
### $  $ #
###.   # #
### #  # #
# * #.   #
#     @# #
###$     #
###    . #
##########
