##########
##  ######
##.   $ ##
### ###  #
#  .##   #
#.$ ## # #
### ##@# #
#.$$ #   #
#       ##
##########
ddlllulruulrdddrrruuuuruullll
