##########
#  #  # .#
#  #.  $ #
# ###$##$#
#   #    #
#   #   ##
# $##.@###
##.  # ###
###    ###
##########
uurruullldddrdddllulluluurdd
