##########
#      * #
#*  #  # #
######## #
######## #
##    .  #
## #  @# #
#*  ##$# #
#   ##   #
##########
urrdddlluu
