##########
#.  #  ###
#   #   .#
# ###### #
#$ ###   #
#    .$ $#
##  . @$ #
#   ###  #
#   ###  #
##########
