##########
#  *    ##
#    #  *#
#######  #
#. ####  #
#  #   # #
# ##  @# #
#    $#* #
#  #    ##
##########
