##########
#       ##
# # #  . #
#  .#.   #
##$$   ###
## .#  ###
# $ # @###
#  $  #  #
#  #     #
##########
