##########
##.      #
##* # $* #
#######. #
#    # $ #
#        #
###  #@# #
######   #
######   #
##########
urruuludrddluruuullldrulll
