##########
#  #  .  #
# * * #$ #
##  ###  #
#   # .# #
#   #    #
##  # @  #
###### $ #
######   #
##########
ddruuruldlurruulurul
