##########
#      ###
#.   #   #
#  ####  #
##  ###  #
#.  #  # #
#.$## @# #
#   $ $* #
#  #    ##
##########
