##########
#  *#    #
#. *#    #
# ####   #
#$ ##### #
#    #   #
##    @# #
# . #  $ #
#        #
##########
urrddlldlurulllulduluu
