##########
#  .  $  #
# $  $ # #
##$##    #
## ####  #
#  .#   ##
# . # @###
#    . ###
##   #####
##########
