##########
#   ######
# . #  ###
##  # .###
#      ###
#   # . ##
## ## @  #
# $ $ $ *#
#    ##  #
##########
