##########
# .####  #
# .## $. #
#  ## ## #
## #     #
#        #
#   ##@$ #
### #.$$ #
###      #
##########
