##########
##  ###. #
#        #
#  #### $#
#######$.#
##   #  ##
## $* @###
# . ##   #
#        #
##########
