##########
####     #
#  # $#  #
#  #. #  #
## $  # ##
#     .  #
#  ## @  #
### *# ###
###  * ###
##########
uluuluurdddldrlllurdru
