##########
####  ####
####   ###
####   ###
##  ##  .#
##  ## *$#
### ##@  #
#   ## #*#
#    $  .#
##########
rrudllddlllulldrrrrrr
