##########
###### ..#
###### $ #
######   #
###  $ # #
##   $   #
##  # @#.#
##  ##   #
## $    .#
##########
