##########
##      ##
##    #  #
#   ###  #
# ####   #
#* #     #
#  #  @###
#  *##   #
#* *##   #
##########
u
