##########
#  .###  #
#       .#
##     # #
# . #.   #
#  ##  $ #
#  ##$@###
#  # $$###
#      ###
##########
