##########
#######  #
##   #   #
##$    ###
#     # .#
#  #     #
#  #  @  #
# $#$  ..#
#.    $ ##
##########
