##########
##     ###
##. $ $  #
###.## . #
##  ### ##
##  ###$ #
# .   @  #
#  ## $# #
#        #
##########
