##########
####  #* #
#        #
#  .#  ###
## .###  #
# $$ #   #
#     @###
#### # $ #
####  .  #
##########
