##########
####  #  #
####     #
#####   ##
# $.##*$ #
# $      #
# ##  @  #
#  ##.   #
#    .   #
##########
