##########
######  ##
#  #     #
#.    .  #
#  # ##  #
#$$$     #
#  #  @. #
#  $ #   #
#  #    .#
##########
