##########
####     #
##.  *#  #
##$#  #  #
##  #### #
### #    #
##   $@# #
# *#  #  #
#   .    #
##########
uldlluuludrddrrduurrrddldll
