##########
####* ####
####     #
##### #$ #
#*.#  #  #
#        #
##    @  #
### ## ###
### $. ###
##########
uluuurrddrdllllldludrddr
